В качестве дополнительного аппаратного обеспечения для получения более точных <e2>результатов распознавания</e2> таких жестов рассмотрено <e1>устройство Microsoft Kinect</e1>.	TOOL
Применение метода K - средних для идентификации пользователя по клавиатурному почерку В данной статье рассматривается проблема защиты от несанкционированного доступа к данным путем идентификации пользователей по <e2>биометрическим характеристикам</e2>, а именно, <e1>клавиатурному почерку</e1>.	ISA
<e2>Задача</e2> решается <e1>методом частиц - в - ячейках</e1>.	TOOL
Применение методов нелинейной динамики для исследования хаотичности сигналов - переносчиков защищенных систем связи на основе динамического хаоса Исследуется <e2>хаотичность передаваемых сигналов защищенных систем связи</e2> на основе динамического хаоса с помощью распространенных <e1>методов нелинейной динамики</e1> ( максимальный показатель Ляпунова, показатель Хёрста и рекуррентные графики ). В качестве защищенной системы связи на основе динамического хаоса рассмотрено устройство имитозащиты контролируемых объектов с повышенной структурной скрытностью сигналов - переносчиков.	TOOL
В результате представлена <e1>архитектура вычислительной системы</e1> для сбора, хранения и <e2>обработки экспериментальных данных</e2>.	USAGE
Практическая ценность приложения <e1>заключается</e1> в том, что оно позволяет достаточно быстро и надежно фиксировать события, а собранные видеоматериалы <e2>могут</e2> быть полезны как в судебных процессах, так и для самостоятельного изучения.	USAGE
Система <e1>предназначена</e1> для анализа множества геномов и их классификации, а именно для анализа <e2>генотипов</e2> внутри одного вида живых организмов, поскольку методы направлены для выделения различий геномов, имеющих схожую структуру.	TOOL
Применение <e1>метода K - средних</e1> для <e2>идентификации пользователя</e2> по клавиатурному почерку В данной статье рассматривается проблема защиты от несанкционированного доступа к данным путем идентификации пользователей по биометрическим характеристикам, а именно, клавиатурному почерку.	USAGE
Под расширенной моделью понимается <e2>тематическая модель</e2>, содержащая кроме <e1>однословных терминов</e1> термины, состоящие из нескольких слов ( также называемые многословные термины или ключевые фра зы ). Такие модели лучше интерпретируются пользователями и точнее описывают предметную область документа, чем модели, состоящие только из униграмм ( отдельных слов ). На основе предложенного подхода была разработана система, в результате работы которой для каждого документа предоставляется набор содержащихся в нем тем с указанными вероятностями, ключевыми словами и фразами для каждой темы.	PART_OF
Адаптация структуры меню услуг для различных типов пользователей с применением онтологического моделирования Статья посвящена решению проблемы <e2>адаптации больших древовидных и линейных меню</e2> мобильных и интернет - услуг для различных типов пользователей на основании их <e1>интересов</e1>, социального статуса, а также иных параметров.	USAGE
На основе результатов проведенного <e1>анализа</e1> предложен ряд <e2>моделей</e2> и механизмов для решения возникших проблем.	CAUSE
Приводится сравнительный экспериментальный анализ трех <e2>методов коллаборативной фильтрации</e2> : на основе документов, на основе пользователей и на основе <e1>гибридного метода</e1>, являющегося комбинацией первых двух методов.	ISA
Показаны варианты применения системы для анализа генетического разнообразия клещей и переносимых ими патогенов при помощи методов статистической обработки в виде круговых и столбчатых диаграмм ( гистограмм ). Описаны реализованные алгоритмы, позволяющие проводить анализ <e2>генетической последовательности</e2> исследуемого патогена на основе L <e1>- граммного подхода</e1> и методами разбиения филогенетического дерева на группы близких последовательностей.	USAGE
Для <e2>оптимизации времени выполнения ресурсоемких расчётов</e2> используются высокопроизводительные <e1>облачные вычисления</e1>.	USAGE
При нажатии на виджет <e1>начинается</e1> видеосъемка <e2>и</e2> отправка получаемой записи в облачный сервис, необходимая для обеспечения сохранности уже полученных данных даже в случае повреждения устройства.	USAGE
Несмотря на большое разнообразие <e1>подходов</e1> к решению данной <e2>задачи</e2>, в частности с использованием метода матрицы структуры проекта, предлагаемые решения не обеспечивают непосредственную связь между элементами описываемой структуры и используемыми аппаратными и программными средствами.	USAGE
На основе <e1>IntelliJ Idea</e1> был разработан <e2>программный инструмент</e2>, который позволяет обнаружить места, где возможно автоматическое преобразование императивного кода в эквивалентный с использованием Stream API, а также автоматическое исправление, которое позволяет произвести замену.	USAGE
Цель данной работы – показать, что при правильном выборе исходных шаблонов поиска <e1>бутстраппинг</e1>, основанный на использовании открытых ресурсов Интернета как ценных источников знаний, превращается в эффективный <e2>инструмент поддержки концептуального моделирования</e2>.	ISA
Применение <e1>методов глубинного обучения</e1> для обнаружения <e2>вторжений</e2> Приведены результаты применения глубоких нейронных сетей для детектирования вредоносной активности в сетевом трафике.	USAGE
Цель представленного исследования – <e2>компьютерный поиск генов</e2> и их изоформ, нарушение экспрессии которых связано с развитием глиобластом, с помощью современных высокопроизводительных технологий секвенирования транскриптом и международных <e1>биомедицинских банков данных</e1>.	USAGE
Применение модельно - ориентированного проектирования к созданию АСУ ТП опасных промышленных объектов Представлена реализация <e2>подхода</e2> « <e1>модельно - ориентированного проектирования</e1> » для решения задачи создания автоматизированных систем управления технологическими процессами ( АСУ ТП ) горнодобывающих предприятий.	ISA
Разработанное новое <e2>программное приложение</e2> основано на web - технологиях и имеет <e1>клиент - серверную архитектуру</e1>.	PART_OF
Для решения этой задачи авторами была проведена серия опытов для получения статистической выборки образцов клавиатурного почерка, которые используются в качестве <e1>биометрической характеристики</e1> для <e2>установления личности</e2> ее владельца.	USAGE
В этой работе используется один из таких <e2>подходов</e2> – <e1>EMSICA</e1> ( Electromagnetic Spatiotemporal Independent Component Analysis ), предложенный A.	ISA
Приведены особенности и преимущества использования естественных интерфейсов и систем <e1>,</e1> основанных на <e2>жестовом управлении</e2>.	SYNONYMS
Для формирования <e2>комплекта оценочных документов</e2> используется <e1>алгоритм CLOPE</e1>, позволяющий кластеризовать категорийные данные.	USAGE
<e1>Система</e1> предлагается в качестве инструмента для решения широкого спектра <e2>задач</e2>, возникающих при проведении b исследований и требующих сбора, хранения и многоэтапной обработки различных типов данных.	USAGE
Основными частями <e2>комплекса</e2> являются : рабочая станция оператора SCADA, рабочая станция оператора модели, среда передачи данных, блок формирования физических сигналов, блок дублирования физических сигналов и <e1>программируемые логические контроллеры АСУ ТП</e1>.	PART_OF
<e2>Значимость предложений</e2> частично определяется в процессе <e1>риторического анализа</e1>, который выполняется с помощью дискурсивных маркеров и коннекторов.	USAGE
<e2>Программа</e2>, реализующая адаптацию меню, состоит из двух модулей : <e1>модуль получения частот вызова услуг</e1> на основе запросов к онтологии и модуль оптимизации графа меню.	PART_OF
Применение методов глубинного обучения для обнаружения вторжений Приведены результаты применения <e1>глубоких нейронных сетей</e1> для <e2>детектирования вредоносной активности</e2> в сетевом трафике.	USAGE
Данная <e1>методика</e1> успешно применена для разработки, <e2>отладки</e2> и тестирования АСКУ ТО М ( Автоматизированная система контроля и управления технологическим объектом во взрывозащищенном исполнении ).	USAGE
<e2>Автоматический рефакторинг Java - кода</e2> с использованием <e1>Stream API</e1> Долгое время функциональное программирование на Java было невозможно.	USAGE
В статье предложен <e2>подход</e2> для решения проблемы разреженности пользовательских оценок на основе использования <e1>оценок связанных объектов</e1>.	USAGE
Оценка эффективности предложенного <e1>метода</e1> для <e2>решения</e2> поставленной задачи оценивается с помощью коэффициентов ложного доступа и ложного отказа в доступе, которые являются основными характеристиками биометрических систем аутентификации.	USAGE
При генерации структурных моделей в случайных графах могут быть зафиксированы следующие <e2>характеристики</e2> : распределение степеней вершин, <e1>попарное распределение степеней вершин</e1>, средняя степень соседних вершин, коэффициент кластеризации, спектр кластеризации, частота структурных мотивов различных размеров и др.	ISA
Предлагаемый метод формирует аннотацию на основе наиболее значимых <e1>предложений</e1> исходного <e2>документа</e2>.	PART_OF
В процессе работы описанного алгоритма могут быть использованы произвольные методы сжатия данных, причем <e2>прогнозные значения</e2> от разных <e1>методов</e1> комбинируются, и наибольшее влияние на конечный результат оказывает метод, способный сильнее других сжать временной ряд.	CAUSE
Бинарные операции в <e2>информационной системе</e2> « <e1>Молекулярная спектроскопия</e1> » Представлен подход, использованный при разработке и реализации модуля, выполняющего бинарные операции над данными в ИС « Молекулярная спектроскопия ». Приводится формализация бинарных операций над наборами спектроскопических данных с учетом особенностей предметной области.	ISA
Применение <e1>методов нелинейной динамики</e1> для исследования <e2>хаотичности сигналов - переносчиков защищенных систем связи</e2> на основе динамического хаоса Исследуется хаотичность передаваемых сигналов защищенных систем связи на основе динамического хаоса с помощью распространенных методов нелинейной динамики ( максимальный показатель Ляпунова, показатель Хёрста и рекуррентные графики ). В качестве защищенной системы связи на основе динамического хаоса рассмотрено устройство имитозащиты контролируемых объектов с повышенной структурной скрытностью сигналов - переносчиков.	USAGE
<e2>Многомерная оптимизация функционала</e2> проводилась <e1>методом дифференциальной эволюции</e1>.	USAGE
Обобщенный алгоритм защищенного информационного обмена для беспроводных систем безопасности с усложненной имитовставкой На основании обобщенного алгоритма <e1>защищенного информационного обмена</e1> для беспроводных <e2>систем безопасности</e2> и защищенного устройства управления группой роботов разработан обобщенный алгоритм защищенного информационного обмена с усложненной имитовставкой для беспроводных систем безопасности.	USAGE
Широко используемый способ разбиения области на прямоугольные ячейки обладает недостатком : при <e2>сложном строении свободной поверхности</e2> ( например, <e1>гора</e1> ) возникают эффекты при отражении волны от этой поверхности, связанные с тем, что граница аппроксимируется ступенчатой функцией для численного решения задачи.	ISA
Для решения <e2>задач геонавигации</e2> используются <e1>алгоритмы</e1>, основанные на методах корреляции каротажных данных и численной инверсии измерений электромагнитного каротажа.	USAGE
Основными частями <e2>комплекса</e2> являются : <e1>рабочая станция оператора SCADA</e1>, рабочая станция оператора модели, среда передачи данных, блок формирования физических сигналов, блок дублирования физических сигналов и программируемые логические контроллеры АСУ ТП.	PART_OF
Разработка программных средств прозрачного удаленного доступа к технологическим параметрам бурения и данным скважинной телеметрической системы в условиях нестабильной связи В процессе бурения нефтегазовых скважин требуется оказание <e2>удаленной поддержки</e2> с использованием существующих каналов связи с офисом, заключающейся в <e1>контроле параметров</e1> и принятии неотложных решений.	PART_OF
На основе предложенного метода создана система, позволяющая получать краткие <e2>аннотации научно - технических текстов</e2> и определять их <e1>темы</e1>.	PART_OF
<e1>Анализ формальных понятий</e1> представляет собой мощный <e2>аппарат автоматического вывода понятий предметной области</e2>, однако он рассчитан на высокое качество входных данных, без пропусков и неточностей.	ISA
Под <e1>расширенной моделью</e1> понимается <e2>тематическая модель</e2>, содержащая кроме однословных терминов термины, состоящие из нескольких слов ( также называемые многословные термины или ключевые фра зы ). Такие модели лучше интерпретируются пользователями и точнее описывают предметную область документа, чем модели, состоящие только из униграмм ( отдельных слов ). На основе предложенного подхода была разработана система, в результате работы которой для каждого документа предоставляется набор содержащихся в нем тем с указанными вероятностями, ключевыми словами и фразами для каждой темы.	ISA
При использовании <e1>нереляционной БД</e1> для выявления <e2>генетического сходства</e2> предложен вариант представления отпечатков структурных вариаций геномов в виде « ключ – значение ». Выполнена программная реализация разработанной модели.	USAGE
Обобщенный алгоритм защищенного информационного обмена для беспроводных систем безопасности с усложненной имитовставкой На основании обобщенного алгоритма защищенного информационного обмена для беспроводных систем безопасности и защищенного устройства управления группой роботов разработан обобщенный алгоритм <e2>защищенного информационного обмена</e2> с усложненной имитовставкой <e1>для</e1> беспроводных систем безопасности.	PART_OF
Система анализа и визуализации для кросс - языковой идентификации авторов научных публикаций Представлена <e2>система разрешения неоднозначности авторства статей</e2> на английском языке с использованием русскоязычных <e1>источников данных</e1>.	USAGE
В процессе применения различных вариаций параметров B <e1>- сплайна</e1> к спектрам <e2>гамма - излучения</e2> оказалось, что квадратичный однородный B - сплайн с интервалом узлов 7.0 показал лучшие результаты в достижении цели улучшения качественной оценки.	USAGE
Для решения этой <e2>задачи</e2> используются <e1>методы преобразования предложений естественного языка</e1> во фрагменты атомарных диаграмм.	USAGE
Сytoscape – плагин для построения структурных моделей биологических сетей в виде случайных графов Современные методы экспериментальных исследований позволяют реконструировать различного типа <e2>биологические сети</e2>, включая генные и метаболические сети, сети интерактомики, сети коэкспрессии генов, <e1>сети заболеваний</e1> и т.	ISA
Чтобы тестировать не только серверную, но и клиентскую часть веб - приложения, мы предлагаем использовать <e1>инструменты</e1> типа Selenium WebDriver для <e2>симуляции действий пользователей</e2>, посылая команды настоящим браузерам.	USAGE
Разработана <e1>программная архитектура</e1> для <e2>расчета системы мелкой воды</e2> без учёта внешних сил, являющейся эквивалентной используемой в пакете MOST для численного моделирования движения волны цунами по водной акватории.	USAGE
Так как спектры <e1>сигнала</e1> являются случайными <e2>величинами</e2>, в ходе рассмотрения различных способов обработки спектров решено применять функции сглаживания, а именно B - сплайн.	ISA
<e1>Программа</e1>, реализующая <e2>адаптацию меню</e2>, состоит из двух модулей : модуль получения частот вызова услуг на основе запросов к онтологии и модуль оптимизации графа меню.	TOOL
Однако в 8.0 версии <e2>Java языке</e2> появились <e1>лямбда - выражения</e1>.	PART_OF
Разработана <e1>программная система</e1>, строящая оптимальное <e2>меню услуг</e2> для классов пользователей, разделенных по социально - экономическим и физическим параметрам, с использованием модифицированного алгоритма построения оптимального графа USSD - меню.	TOOL
Под расширенной моделью понимается тематическая модель, содержащая кроме однословных терминов термины, состоящие из нескольких слов ( также называемые многословные термины или ключевые фра зы ). Такие модели лучше интерпретируются пользователями и точнее описывают предметную область документа, чем модели, состоящие только из <e1>униграмм</e1> ( <e2>отдельных слов</e2> ). На основе предложенного подхода была разработана система, в результате работы которой для каждого документа предоставляется набор содержащихся в нем тем с указанными вероятностями, ключевыми словами и фразами для каждой темы.	SYNONYMS
Метод повышения робастных свойств линейной замкнутой системы в условиях структурно - параметрической неопределенности описания передаточной функции объекта управления Для <e2>линейных систем управления</e2>, состоящих из <e1>объекта управления</e1> со структурно - параметрической неопределенностью в описании и модального регулятора, обоснована мера робастных свойств устойчивости и качества управления.	PART_OF
Отсутствие универсальной <e2>модели данных</e2> с проработанным <e1>математическим аппаратом</e1> ( как в случае реляционных баз данных ) и сегодня является основной проблемой распространения ООСУБД.	PART_OF
Подход <e2>базируется</e2> на наборе MATLAB - скриптов, использующих библиотеки EEGLAB, NeuroElf, Alphasim, spm8, Mediation toolbox, и программном <e1>пакете sLORETA</e1>.	USAGE
Использование <e1>горизонтально масштабируемой инфраструктуры</e1> при <e2>поиске сходства</e2> в геномных данных экосистем Рассмотрена проблема выявления генетического сходства при анализе баз данных ( БД ) геномов организмов.	USAGE
В последнее время большинство экзаменационных комиссий используют <e1>компьютерное адаптивное тестирование</e1> ( <e2>CAT</e2> ) в качестве метода широкомасштабного тестирования.	SYNONYMS
Описан <e2>алгоритм порождения шаблона оценочного документа</e2>, состоящий из трех этапов : сужение, ограничение и <e1>определение</e1>.	PART_OF
<e1>Решение уравнения Пуассона</e1> для <e2>гравитационного потенциала</e2> выполняется с использованием быстрого преобразования Фурье.	USAGE
Для извлечения <e2>ключевых слов</e2> и определения тем текста применялась <e1>аддитивная регуляризация тематических моделей</e1>.	USAGE
Модели и проектные решения системы хранения и обработки исследовательских данных Ecclesia В ходе научных исследований порождается большое количество данных в цифровом формате, и для после - дующего использования этих <e1>данных</e1> ( обработки, <e2>анализа</e2>, публикации ) их необходимо организованно собирать и хранить.	USAGE
<e1>Бинарные операции</e1> в <e2>информационной системе</e2> « Молекулярная спектроскопия » Представлен подход, использованный при разработке и реализации модуля, выполняющего бинарные операции над данными в ИС « Молекулярная спектроскопия ». Приводится формализация бинарных операций над наборами спектроскопических данных с учетом особенностей предметной области.	USAGE
Разработка автоматизированного модуля минерализации поливной воды Статья посвящена разработке <e1>системы управления фертигацией</e1>, которая позволяет осуществлять <e2>автоматическую подачу удобрений</e2> с учетом показателей pH и EC, полученных от соответствующих датчиков.	USAGE
Значимость предложений частично определяется в процессе <e2>риторического анализа</e2>, который выполняется с помощью <e1>дискурсивных маркеров</e1> и коннекторов.	USAGE
Разработка и реализация алгоритмов разрешения конфликтов по доступу к памяти в динамическом компиляторе Java для процессора « Эльбрус » Рассмотрены особенности разработки алгоритмов разрешения конфликтов по доступу к памяти и их реализация в динамическом компиляторе Java для отечественной <e2>платформы</e2> « <e1>Эльбрус</e1> ». Эти алгоритмы позволяют существенно расширить возможности планировщика инструкций – ключевой оптимизации VLIW - процессоров.	ISA
Благодаря поддержке стандартных <e2>библиотечных классов</e2> ( <e1>Stream</e1>, Optional и т.	ISA
В процессе бурения <e2>геонавигация скважины со сложной траекторией</e2> выполняется по <e1>геофизическим данным</e1> в реальном масштабе времени.	USAGE
Исследование производительности приложений баз данных : транзакционная модель и архитектура имитационной системы Высокий уровень изменчивости программного и технического обеспечения информационных систем требует получения оценок их производительности за ограниченные сроки на любых <e1>стадиях</e1> их <e2>жизненного цикла</e2>.	PART_OF
Разработан <e1>алгоритм вариации настроек модального регулятора</e1>, последовательно повышающий <e2>меру робастности замкнутой системы</e2>.	USAGE
Предложенный в статье <e1>подход</e1> может быть полезен при построении <e2>рекомендательных систем</e2> и систем авто - реферирования.	USAGE
Рефакторинг пользуется средствами <e1>IntelliJ Idea</e1> для <e2>анализа</e2> Java кода, а также интегрируется в саму IDE.	USAGE
Программы статистической обработки, <e1>кластеризации</e1> и визуализации распределения <e2>сайтов связывания транскрипционных факторов</e2> в геноме Исследование регуляции транскрипции генов на основе данных современных технологий высокопроизводительного секвенирования является актуальной задачей биоинформатики, требующей развития новых компьютерных средств, в том числе на основе суперкомпьютерных вычислений.	USAGE
С помощью <e1>методов нелинейной динамики</e1>, проведено исследование <e2>временных реализаций</e2> передаваемых в канале связи сигналов, полученных в среде ScicosLab с помощью рассматриваемого устройства.	USAGE
Разработка программных средств прозрачного удаленного доступа к технологическим параметрам бурения и данным скважинной телеметрической системы в условиях нестабильной связи В процессе бурения нефтегазовых скважин требуется оказание <e2>удаленной поддержки</e2> с использованием существующих каналов связи с офисом, заключающейся в контроле параметров и <e1>принятии неотложных решений</e1>.	PART_OF
Несмотря на впечатляющее количество проектов, проводимых как коллективами ученых, так и коммерческими компаниями, ориентированными на практическое внедрение, не появилось четкой формулировки объектно - ориентированной модели данных, каждый коллектив представлял свое видение применения <e1>принципов ООП</e1> к <e2>проектированию баз данных</e2>.	USAGE
Описание долговременной эволюции берегового профиля на основе диффузионной модели Рассматривается <e1>диффузионная модель</e1> для описания <e2>долговременной эволюции профиля глубин</e2> в прибрежной зоне.	TOOL
<e2>Порождение новых знаний</e2> реализуется при помощи автоматических средств логического вывода с использованием заранее заданных <e1>шаблонов правил вывода</e1>.	USAGE
Подход базируется на наборе MATLAB <e2>- скриптов</e2>, использующих библиотеки EEGLAB, NeuroElf <e1>,</e1> Alphasim, spm8, Mediation toolbox, и программном пакете sLORETA.	USAGE
В качестве системы принятия решений в работе использована <e2>интеллектуальная система</e2> на основе <e1>нечеткой логики</e1>.	USAGE
Авторами настоящей статьи разрабатывается <e2>информационная система</e2> для автоматизации сбора, хранения и анализа данных, в качестве отправной точки для которой используются три <e1>задачи обработки данных</e1> из области физиологии.	USAGE
Разработаны комплексы алгоритмов и <e1>компьютерных программ</e1> для <e2>анализа сигналов электромагнитного зонда</e2> с тороидальными катушками в пространственно неоднородных анизотропных средах.	USAGE
Подход основан на использовании математических моделей, имитирующих протекание <e2>технологического процесса</e2> под управлением <e1>АСУ ТП</e1>.	USAGE
Для эффективного использования аппаратурного комплекса было создано <e1>программное обеспечение QZond</e1>, позволяющее управлять <e2>процессом сбора информации</e2> и в режиме реального времени визуализировать полученные данные.	TOOL
По результатам масштабного <e1>моделирования амплитудно - фазовых характеристик высокочастотного поля</e1> установлена их <e2>зависимость</e2> от частотного спектра электрофизических параметров.	CAUSE
Автоматизация построения трехмерных геоэлектрических моделей для метода зонди - рования становлением поля в ближней зоне на основе результатов одномерной инверсии Предложен алгоритм автоматизации построения трехмерных геоэлектрических моделей для метода зондирования становлением поля в ближней зоне на основе результатов одномерной инверсии с целью расчета <e1>синтетических сигналов</e1> для <e2>трехмерных моделей</e2>, а также ускорения получения качественной оценки полевых материалов и сведения к минимуму ошибок интерпретации.	USAGE
В рамках данной работы разработано <e1>программное средство прозрачного доступа</e1> к параметрам бурения и данным скважинной телеметрической системы с целью организации <e2>удаленного сопровождения</e2> по существующим каналам связи с учетом их ограничений.	USAGE
<e2>Методика повышения производительности небольших информационных систем</e2> за счет <e1>оптимальной реструктуризации данных</e1> на основе многомодального распределения атрибутов Рассматривается системный подход к повышению производительности небольших информационных систем за счет оптимальной реструктуризации табличных структур данных.	USAGE
Разработка музыкальной рекомендательной системы на основе обработки метаданных контента <e1>Музыкальная рекомендательная система</e1> ( <e2>МРС</e2> ) помогает пользователям музыкальных стриминговых сервисов находить интересующий их музыкальный контент.	SYNONYMS
При этом для первичной обработки набора <e2>геномов</e2> используются методы множественного выравнивания последовательностей и метод <e1>присоединения соседей</e1>, позволяющий выполнить построение филогенетического дерева.	USAGE
<e2>Расчет</e2> гравитационного взаимодействия осуществляется путем решения <e1>уравнения Пуассона</e1> для гравитационного потенциала.	USAGE
В статье рассмотрены основные этапы работы системы <e2>,</e2> такие как мониторинг <e1>сейсмической активности</e1>, извлечение данных с DART станций, фильтрация приливной компоненты, расчет времени добегания волны и непосредственно моделирование, и промежуточные шаги, связанные с предобработкой и трансформацией данных.	PART_OF
Платформа комплексирования и тестирования средств трансформации естественно - языковых запросов в SPARQL - запросы Статья посвящена вопросу поддержки процесса создания <e1>средства трансформации естественно - языковых</e1> ( ЕЯ ) запросов в SPARQL - запросы ( далее – <e2>средство трансформации</e2> ). Во введении описаны актуальность задачи понимания естественно - языковых запросов информационными системами, а также преимущества использования онтологий как средства представления знаний для решения данной задачи.	SYNONYMS
Описана <e2>предметная область</e2>, связанная с распространением клещей и переносимыми ими заболеваниями, представлена ее семантическая структура, выделены основные <e1>разделы информационного наполнения</e1> и показаны способы навигации по ресурсу.	PART_OF
В данной работе рассматривается <e2>задача построения</e2> подобных интерфейсов путем <e1>автоматизированного извлечения речевых действий</e1> из текстов естественного языка.	USAGE
В статье рассмотрены основные <e2>этапы работы системы</e2>, такие как <e1>предварительная обработка исходных данных</e1> ; расчет специальной матрицы подхода EMSICA, значения которой показывают уровень активности определенного участка мозга ; визуализация источников активности мозга на его трехмерной модели.	ISA
Описана <e2>гибридная МРС</e2>, использующая как нормализованные <e1>пользовательские оценки треков</e1>, альбомов, артистов, жанров, так и информацию о связях между объектами разных типов.	USAGE
Разработанные <e2>решения</e2> включают в себя <e1>модели</e1> и механизмы сбора и хранения экспериментальных данных, модель для описания и формализации сценариев обработки данных и механизмы для обработки собранных данных в распределенной вычислительной системе.	PART_OF
Система позволяет асинхронно конструировать <e2>структурные модели заданных биологических сетей</e2> в виде случайных графов посредством программ Random Network Generator и <e1>GTrie Scanner</e1>.	USAGE
Разработаны <e1>программы</e1> для анализа положения сайтов связывания в геноме относительно районов генов, расчета <e2>кластеров</e2> таких сайтов и визуализации их положения в геноме.	USAGE
Прагматический уровень включает в себя исследования по автоматическому определению высокоуровневых <e2>характеристик поэтического текста</e2>, таких как жанр <e1>и</e1> стиль.	ISA
Адаптация структуры меню услуг для различных типов пользователей с применением онтологического моделирования Статья посвящена решению проблемы адаптации больших древовидных и линейных меню мобильных и интернет - услуг для различных типов пользователей на основании их интересов, <e1>социального статуса</e1>, а также иных <e2>параметров</e2>.	ISA
Оценка эффективности предложенного метода для решения поставленной задачи оценивается с помощью коэффициентов ложного доступа и <e1>ложного отказа в доступе</e1>, которые являются основными <e2>характеристиками</e2> биометрических систем аутентификации.	ISA
Проведен сравнительный анализ <e1>реляционного</e1> и графового подходов к <e2>хранению базовых сущностей</e2>.	USAGE
В статье предлагается <e2>подход получения определяющих признаков объекта</e2> на основе его <e1>внешнего представления</e1> ( контуров ).	USAGE
Проведены вычислительные эксперименты : 1.0 ) загрузка данных в БД с использованием одной и трех <e1>шард</e1> ( <e2>серверов</e2>, где хранятся данные и осуществляются поиск и обработка информации ); 2.0 ) поиск совпадений выбранных наборов нуклеотидов с БД геномов с использованием одной и трех шард ; 3.0 ) расчет скорости поиска геномов в БД ; 4.0 ) расчет скорости загрузки геномов в БД.	ISA
В статье предложен <e1>подход</e1> для решения <e2>проблемы разреженности пользовательских оценок</e2> на основе использования оценок связанных объектов.	USAGE
Для решения этой задачи разработан <e2>модуль минерализации</e2>, состоящий из двух подмодулей : <e1>подмодуль измерения</e1> и регулирования pH и подмодуль измерения и регулирования EC.	PART_OF
С использованием разработанной <e1>системы</e1> проведен <e2>вычислительный эксперимент</e2> по реконструкции структурных моделей ряда биологических сетей, для которых удалось построить алгоритм предсказания времени расчетов структурных моделей.	USAGE
<e1>Код</e1> « Виртуальный планетарий » для <e2>моделирования астрофизических объектов</e2> : математическая модель, методология и первые результаты Сложность астрофизических процессов заключается в совместном рассмотрении компонент различной природы.	USAGE
Учитывая собственный практический опыт в данной сфере, автор предлагает автоматизировать составление html / css - макета путём <e1>агрегирования прецедентов кода</e1> из предыдущих опытов, что на методологическом уровне крайне близко к <e2>подходу CBR</e2>, а именно : предлагается методика конструирования систем, генерирующих html - код из растрового изображения и основанных на подходе рассуждений на основе прецедентов.	COMPARE
Теоретико - алгоритмическая база и <e1>компьютерное моделирование данных диэлектрического каротажа</e1> для изучения <e2>частотного спектра электрофизических параметров геологической среды</e2> Статья посвящена разработке теоретической базы компьютерного моделирования данных диэлектрического каротажа с целью обоснования нового импортозамещающего оборудования для каротажа нефтяных и газовых скважин.	TOOL
Для восстановления <e2>трехмерной геометрии</e2> применяется комбинация двух основных <e1>методов</e1> : трехмерного алгоритма роста области из семени и ячеечного метода, использующего разбиение пространства на тетраэдры.	USAGE
Данная <e1>методика</e1> успешно применена для разработки, отладки и <e2>тестирования АСКУ ТО М</e2> ( Автоматизированная система контроля и управления технологическим объектом во взрывозащищенном исполнении ).	USAGE
Оптимизация переупорядочивания модельных частиц при реализации метода частиц в ячейках на GPU Представлено описание реализации метода <e1>частиц в ячейках</e1> на GPU <e2>.</e2>	USAGE
Рассмотрена архитектура <e2>приложения</e2>, построенная на базе шаблона <e1>проектирования MVC</e1> и включающая в себя 6.0 модулей.	USAGE
Применение модельно - ориентированного проектирования к созданию АСУ ТП опасных промышленных объектов Представлена реализация подхода « модельно - ориентированного проектирования » для решения задачи создания <e1>автоматизированных систем управления технологическими процессами</e1> ( <e2>АСУ ТП</e2> ) горнодобывающих предприятий.	SYNONYMS
Математическое обоснование нового электромагнитного зонда с тороидальными катушками для высокоразрешающего каротажа нефтегазовых скважин Представленная работа посвящена обоснованию нового электромагнитного зонда для <e2>каротажа нефтегазовых скважин</e2> на основе <e1>компьютерного моделирования</e1>.	USAGE
Разработан тестовый <e1>интерфейс</e1> для доступа к хранилищу информационной <e2>системы</e2>.	USAGE
Адаптация структуры меню услуг для различных типов пользователей с применением онтологического моделирования Статья посвящена решению проблемы адаптации больших древовидных и линейных меню мобильных и интернет - услуг для различных типов пользователей на основании их <e1>интересов</e1>, социального статуса, а также иных <e2>параметров</e2>.	ISA
Предлагаемый <e2>метод</e2> формирует аннотацию на основе наиболее значимых <e1>предложений</e1> исходного документа.	USAGE
Представленная работа посвящена разработке нового <e1>программного обеспечения</e1> для <e2>геонавигации нефтегазовых скважин с горизонтальным завершением</e2>.	USAGE
Разработаны <e1>программы</e1> для анализа положения сайтов связывания в геноме относительно районов генов, расчета кластеров таких сайтов и <e2>визуализации</e2> их положения в геноме.	USAGE
<e2>База знаний</e2> о свободном времени пользователя формируется на основе <e1>задач</e1>, которые агрегируются с мобильного устройства и популярных сервисов по управлению задачами.	USAGE
Для <e2>анализа данных</e2> и определения автора конкретного образца почерка в работе рассматривается <e1>метод k - средних</e1>, являющийся одним из наиболее простых и эффективных статистических методов классификации в случае, когда число кластеров заранее известно.	USAGE
Для формирования комплекта оценочных документов используется <e1>алгоритм CLOPE</e1>, позволяющий кластеризовать <e2>категорийные данные</e2>.	USAGE
<e2>Автоматическое извлечение решеток понятий</e2> из медицинских текстов на основе <e1>комбинации анализа формальных понятий</e1> и технологий бутстраппинга Рассматривается новый способ извлечения понятий из текстов предметной области на основе комбинации анализа формальных понятий и бутстрап - технологии информационного поиска.	USAGE
Также детально рассмотрены этапы формирования базового словаря жестов для дальнейшего его применения в <e2>бесконтактном интерфейсе</e2>. <e1>В</e1>	ISA
Соответственно, представляется перспективным улучшение качества входных данных за счет применения <e1>бутстраппинга</e1> – <e2>технологии</e2>, обеспечивающей интеллектуальный поиск фрагментированной информации в сети Интернет.	ISA
Большинство <e2>сред разработки</e2> языка C ++ для Android не имеют <e1>автодополнения</e1> и анализа кода, в то время как остальные предоставляют эти возможности с крайне низкой производительностью.	PART_OF
В системе реализован алгоритм построения и оценки всевозможных индивидуальных траекторий обучения студента в рамках данной ООП, а также <e1>модуль рекомендательной системы</e1>, помогающей пользователям ( студентам ) в выборе <e2>индивидуальных траекторий обучения</e2>.	TOOL
Целью данной работы является объединение существующих реализаций алгоритмов, написанных на разных языках <e2>программирования</e2> ( С ++, Си <e1>,</e1> Python, Kotlin, Fortran и т.	ISA
Моделирование структурной организации единого информационного пространства предприятия - разработчика микроэлектронных систем При формировании <e2>единого информационного пространства</e2> ( ЕИП ) широко используется <e1>моделирование</e1> как объектов информационного обмена, так и инфраструктуры ЕИП.	USAGE
В работе используется <e1>онтологический подход</e1> для формального представления понятий данной предметной области, извлечения, представления и <e2>обработки знаний</e2>.	USAGE
Несмотря на большое разнообразие подходов к решению данной задачи, в частности с использованием метода матрицы структуры проекта, предлагаемые решения не обеспечивают непосредственную связь между <e1>элементами</e1> описываемой <e2>структуры</e2> и используемыми аппаратными и программными средствами.	PART_OF
Для <e2>извлечения знаний</e2> из текстов на естественном языке используется <e1>метод представления предложений в виде двухместных предикатов</e1> с введенной константой ситуацией.	USAGE
Применение FPGA для ускорения расчета волнового фронта цунами Рассматривается вопрос ускорения численного расчёта распространения волны цунами от очага до берега в рамках дифференциальной модели мелкой воды с применением <e2>аппаратного ускорения</e2> на базе <e1>FPGA</e1>.	USAGE
В работе используется <e1>онтологический подход</e1> для формального представления понятий данной предметной области, <e2>извлечения</e2>, представления и обработки знаний.	USAGE
Рассмотрена архитектура <e2>приложения</e2>, построенная на базе шаблона проектирования MVC и включающая в себя 6.0 модулей <e1>.</e1>	PART_OF
Разработка программных средств прозрачного удаленного доступа к технологическим параметрам бурения и данным скважинной телеметрической системы в условиях нестабильной связи В процессе бурения нефтегазовых скважин требуется оказание <e2>удаленной поддержки</e2> с использованием существующих <e1>каналов связи</e1> с офисом, заключающейся в контроле параметров и принятии неотложных решений.	USAGE
Соответственно, представляется перспективным улучшение качества входных данных за счет применения бутстраппинга – <e1>технологии</e1>, обеспечивающей <e2>интеллектуальный поиск фрагментированной информации</e2> в сети Интернет.	USAGE
Экспериментальное исследование эффективности предложенного <e2>алгоритма</e2> проводилось на временных рядах из M3 Competition и ряде T - индекса, при этом были использованы хорошо известные <e1>архиваторы</e1>.	USAGE
Атрибутная конвейерная модель для интерактивной визуализации объектных связей Определена <e1>модель</e1> для <e2>визуализации связей между объектами</e2> и их атрибутами в различных процессах.	USAGE
Разработанный алгоритм <e2>с</e2> усложненной имитовставкой <e1>может</e1> найти применение в различных областях беспроводных систем безопасности, в которых требуется защита передаваемых по радиоканалу тревожных и служебных сообщений от несанкционированного доступа.	PART_OF
В статье представлен опыт разработки и внедрения в НИУ МЭИ <e1>информационной системы</e1>, автоматизирующей <e2>процесс распределения студентов</e2> по базам практик и подготовку сопутствующей документации.	TOOL
<e1>Сytoscape</e1> – плагин для <e2>построения структурных моделей биологических сетей</e2> в виде случайных графов Современные методы экспериментальных исследований позволяют реконструировать различного типа биологические сети, включая генные и метаболические сети, сети интерактомики, сети коэкспрессии генов, сети заболеваний и т.	USAGE
Авторами настоящей статьи разрабатывается <e1>информационная система</e1> для автоматизации сбора, <e2>хранения</e2> и анализа данных, в качестве отправной точки для которой используются три задачи обработки данных из области физиологии.	USAGE
Программная система управления образовательным процессом ИТОС Статья посвящена описанию программной системы ИТОС ( индивидуальных траекторий обучения студентов ), предназначенной для автоматизации работы с <e1>основной образовательной программой</e1> ( <e2>ООП</e2> ) и соответствующим ей учебным планом.	SYNONYMS
Программы статистической обработки, кластеризации и визуализации распределения сайтов связывания транскрипционных факторов в геноме Исследование <e2>регуляции транскрипции генов</e2> на основе данных современных <e1>технологий высокопроизводительного секвенирования</e1> является актуальной задачей биоинформатики, требующей развития новых компьютерных средств, в том числе на основе суперкомпьютерных вычислений.	USAGE
Авторами настоящей статьи разрабатывается <e1>информационная система</e1> для автоматизации сбора, хранения и <e2>анализа данных</e2>, в качестве отправной точки для которой используются три задачи обработки данных из области физиологии.	USAGE
Платформа комплексирования и тестирования средств трансформации естественно - языковых запросов в SPARQL - запросы Статья посвящена вопросу поддержки процесса создания средства трансформации естественно - языковых ( ЕЯ ) запросов в SPARQL - запросы ( далее – средство трансформации ). Во введении описаны актуальность задачи понимания естественно - языковых запросов информационными системами, а также преимущества использования <e1>онтологий</e1> как средства представления знаний для решения данной <e2>задачи</e2>.	USAGE
Метод повышения робастных свойств линейной замкнутой системы в условиях структурно - параметрической неопределенности описания передаточной функции объекта управления Для <e2>линейных систем управления</e2>, состоящих из объекта управления со структурно - параметрической неопределенностью в описании и <e1>модального регулятора</e1>, обоснована мера робастных свойств устойчивости и качества управления.	PART_OF
Системы автоматизированной оценки заданий по программированию : разработка, использование и перспективы В статье приведен обзор существующих <e1>систем проверки заданий по программированию</e1>, кратко описано современное состояние архитектуры системы NSUts, созданной в Новосибирском государственном университете, и практика ее использования в учебном процессе и в <e2>олимпиадах по программированию</e2> различного уровня.	USAGE
Обобщенный <e1>алгоритм защищенного информационного обмена</e1> для <e2>беспроводных систем безопасности</e2> с усложненной имитовставкой На основании обобщенного алгоритма защищенного информационного обмена для беспроводных систем безопасности и защищенного устройства управления группой роботов разработан обобщенный алгоритм защищенного информационного обмена с усложненной имитовставкой для беспроводных систем безопасности.	USAGE
Целью работы является разработка сервиса, позволяющего задавать <e2>сценарии представления стимулов</e2> с помощью <e1>графического интерфейса</e1> с возможностью сохранять метаинформацию эксперимента в независимом от платформы формате и исполнять в закрытых системах.	USAGE
Некоторые подходы к хранению информации о книгообеспеченности учебного процесса высшего учебного заведения Рассматриваются три <e2>подхода к хранению информации</e2> о книгообеспеченности учебного процесса при различных вариантах интеграции автоматизированной библиотечной информационной системы ( АБИС ) с информационной системой вуза : внутри АБИС в формате RUSMARC, в виде <e1>реляционной базы данных</e1>, с использованием технологии OLAP.	ISA
Построение <e1>информационной инфраструктуры</e1> для решения этих <e2>задач</e2> – одна из наиболее актуальных проблем в области организации работы с экспериментальными данными.	USAGE
Программная <e2>система</e2> разбита на модули <e1>.</e1>	PART_OF
Формирование базового словаря жестов для естественного компьютерного бесконтактного интерфейса Исследуются возможности бесконтактных систем <e2>и</e2> интерфейсов, главные принципы работы с такими технологиями. Рассмотрена возможность применения подобных <e1>систем</e1>	USAGE
Под расширенной моделью понимается тематическая модель, содержащая кроме однословных терминов термины, состоящие из нескольких слов ( также называемые <e1>многословные термины</e1> или <e2>ключевые фра зы</e2> ). Такие модели лучше интерпретируются пользователями и точнее описывают предметную область документа, чем модели, состоящие только из униграмм ( отдельных слов ). На основе предложенного подхода была разработана система, в результате работы которой для каждого документа предоставляется набор содержащихся в нем тем с указанными вероятностями, ключевыми словами и фразами для каждой темы.	SYNONYMS
Разработка среды программирования для мобильных устройств под управлением операционной системы Android <e1>Мобильные устройства</e1> часто используются для <e2>образовательных целей</e2>, учитывая их высокую доступность и портативность.	USAGE
Перспективной <e2>сферой</e2> являются <e1>объекты агропромышленного комплекса</e1> – оценка плодородности почв ( распределение минерализации ), контроль эффективности мелиорации.	ISA
Также были реализованы две параллельные версии алгоритма, проведены расчеты на различных <e2>многоядерных системах</e2> ( на <e1>классической многопроцессорной архитектуре</e1>, а также архитектуре с использованием сопроцессоров Intel Xeon Phi – " РСК ПетаСтрим "). Представлены сравнительные тесты ускорений на разных архитектурах, а также описаны особенности распараллеливания алгоритма.	ISA
<e1>Система</e1> предлагается в качестве <e2>инструмента</e2> для решения широкого спектра задач, возникающих при проведении b исследований и требующих сбора, хранения и многоэтапной обработки различных типов данных.	ISA
В этой работе мы описываем технологию переноса программного обеспечения, примененную к компилятору Clang ( и другим необходимым инструментам ) и предлагаем <e1>метод ускорения компиляции</e1>, автодополнения и анализа кода в нашей <e2>IDE</e2>.	PART_OF
Под расширенной моделью понимается тематическая модель, содержащая кроме однословных терминов термины, состоящие из нескольких слов ( также называемые многословные термины или ключевые фра зы ). Такие модели лучше интерпретируются пользователями и точнее описывают предметную область документа, чем <e2>модели</e2>, состоящие только из <e1>униграмм</e1> ( отдельных слов ). На основе предложенного подхода была разработана система, в результате работы которой для каждого документа предоставляется набор содержащихся в нем тем с указанными вероятностями, ключевыми словами и фразами для каждой темы.	PART_OF
К типичным сферам применения подобных комплексов можно отнести : исследование <e2>археологических объектов</e2> – курганы, <e1>древние поселения</e1> ; решение экологических задач – изучение отвалов и хвостохранилищ горнодобывающих предприятий, зон распространения вредных веществ ; локализация инженерных объектов – труб и коммуникаций, исследование состояния дамб и плотин.	ISA
Знания, извлеченные из текстов, формализуются при помощи <e2>атомарных предложений сигнатуры</e2>, состоящей из символов констант, <e1>двухместных предикатов</e1> и дополнительных констант - ситуаций.	PART_OF
Разработаны <e1>программы</e1> для <e2>анализа положения сайтов связывания</e2> в геноме относительно районов генов, расчета кластеров таких сайтов и визуализации их положения в геноме.	USAGE
Сравнительный анализ использования <e1>реляционных</e1> и графовых баз данных в разработке <e2>цифровых образовательных систем</e2> Рассмотрены вопросы выбора варианта реализации базы данных при разработке цифровых образовательных систем.	USAGE
<e2>Код</e2> « <e1>Виртуальный планетарий</e1> » для моделирования астрофизических объектов : математическая модель, методология и первые результаты Сложность астрофизических процессов заключается в совместном рассмотрении компонент различной природы.	ISA
Компьютерный анализ альтернативного сплайсинга генов в культурах клеток глиом по данным RNA - seq Современные <e1>постгеномные методы изучения</e1> экспрессии генов с помощью транскриптомного профилирования имеют большое значение для <e2>фундаментальных биомедицинских исследований</e2> в онкологии, поиска новых маркеров развития опухолей на культурах клеток глиом.	USAGE
Программа, реализующая адаптацию меню, состоит из двух <e2>модулей</e2> : модуль получения частот вызова услуг на основе запросов к онтологии и <e1>модуль оптимизации графа меню</e1>.	ISA
В результате <e1>прототипирования</e1> создана оптимальная <e2>конструкция корпуса</e2>, позволяющая реализовать данный принцип компенсации.	CAUSE
Компьютерная база данных для <e2>анализа дифференциально экспрессирующихся генов</e2>, связанных с агрессивным поведением, на <e1>моделях лабораторных животных</e1> Разработка и применение компьютерных средств анализа транскриптомных данных в модельных организмах животных представляет актуальную задачу биоинформатики.	USAGE
Разработка <e1>системы оценки параметров цунами</e1> у <e2>прибрежных территорий</e2> Проблема своевременного предупреждения населения об опасности цунами всё еще является актуальной на прибрежных территориях всего мира.	USAGE
Оказалось, что около половины выдающихся ученых имеют свой <e1>персональный сайт</e1> на русском языке, но из них более 90.0 % не имеют <e2>сайта</e2> на английском.	COMPARE
Описан <e2>алгоритм порождения шаблона оценочного документа</e2>, состоящий из трех этапов : <e1>сужение</e1>, ограничение и определение.	PART_OF
Некоторые подходы к хранению информации о книгообеспеченности учебного процесса высшего учебного заведения Рассматриваются три подхода к хранению информации о книгообеспеченности учебного процесса при различных вариантах интеграции автоматизированной библиотечной информационной системы ( АБИС ) с <e1>информационной системой</e1>  <e2>вуза</e2> : внутри АБИС в формате RUSMARC, в виде реляционной базы данных, с использованием технологии OLAP.	PART_OF
Программа, реализующая адаптацию меню, состоит из двух <e2>модулей</e2> : <e1>модуль получения частот вызова услуг</e1> на основе запросов к онтологии и модуль оптимизации графа меню.	ISA
<e1>Математическое моделирование упругопластических деформаций</e1> для <e2>задач образования</e2> и эволюции геологических трещин Представлена математическая модель упругопластических сред с учетом фазовых переходов между твердым телом, жидкостью и газом.	USAGE
Разработка прецедентно - ориентированного подхода обратного реинжиниринга web - интерфейсов Статья посвящена применению рассуждений на основе прецедентов ( <e1>case - based reasoning</e1>, <e2>CBR</e2> ) в области web - разработки.	SYNONYMS
Применение методов нелинейной динамики для исследования хаотичности сигналов - переносчиков защищенных систем связи на основе динамического хаоса Исследуется хаотичность передаваемых сигналов защищенных систем связи на основе динамического хаоса с помощью распространенных методов нелинейной динамики ( максимальный показатель Ляпунова, показатель Хёрста и рекуррентные графики ). В качестве <e2>защищенной системы связи</e2> на основе динамического хаоса рассмотрено <e1>устройство имитозащиты контролируемых объектов</e1> с повышенной структурной скрытностью сигналов - переносчиков.	ISA
Система позволяет асинхронно конструировать <e2>структурные модели заданных биологических сетей</e2> в виде случайных графов посредством <e1>программ Random Network Generator</e1> и GTrie Scanner.	USAGE
<e1>Распараллеливание</e1> по области и по частицам позволяет проводить <e2>численные эксперименты</e2> с 10.0 ^ 9.0 модельных частиц.	TOOL
Оценка эффективности предложенного метода для решения поставленной задачи оценивается с помощью <e1>коэффициентов ложного доступа</e1> и ложного отказа в доступе, которые являются основными <e2>характеристиками</e2> биометрических систем аутентификации.	ISA
Экспериментальное исследование точности <e2>методов прогноза</e2>, базирующихся на <e1>архиваторах</e1> В теории информации известно, что методы сжатия данных могут быть использованы для прогнозирования стационарных процессов.	USAGE
В работе используется <e1>онтологический подход</e1> для формального представления понятий данной предметной области, извлечения, <e2>представления</e2> и обработки знаний.	USAGE
Для <e2>калибровки модели</e2> решалась <e1>обратная задача восстановления коэффициентов</e1> по дополнительным граничным условиям путем минимизации функционала невязки.	USAGE
При генерации структурных моделей в случайных графах могут быть зафиксированы следующие <e2>характеристики</e2> : распределение степеней вершин, попарное распределение степеней вершин, средняя степень соседних вершин, <e1>коэффициент кластеризации</e1>, спектр кластеризации, частота структурных мотивов различных размеров и др.	ISA
Так, например, в <e2>задаче столкновения галактик</e2> рассматривается <e1>трехмерная динамика межзвездного газа</e1> и звездной компоненты.	PART_OF
До начала проведения практики каждый студент должен быть прикреплен к определённой <e1>базе практики</e1> – <e2>учреждению</e2> с соответствующей профилю подготовки обучающегося специализацией, которое будет осуществлять проведение и контроль практических занятий.	ISA
<e1>Мобильное приложение</e1> непрерывной передачи <e2>видеоданных</e2> в облачные сервисы Представлен способ получения видеодоказательств с помощью мобильного устройства – приложения для Android, позволяющего оперативно начать видеотрансляцию в облачные сервисы.	USAGE
Для извлечения ключевых слов и определения <e2>тем текста</e2> применялась <e1>аддитивная регуляризация тематических моделей</e1>.	USAGE
<e1>Онтологический подход</e1> к <e2>моделированию фонда оценочных средств</e2> позволяет формировать актуальные оценочные документы, которые учитывают не только всевозможные пожелания экзаменатора, но и степень усвоения различных компетенций и степень овладения различными профессиональными функциями.	USAGE
Модели и проектные решения системы хранения и обработки исследовательских данных Ecclesia В ходе научных исследований порождается большое количество данных в цифровом формате, и для после - дующего использования этих <e1>данных</e1> ( обработки, анализа, <e2>публикации</e2> ) их необходимо организованно собирать и хранить.	USAGE
Разработка прецедентно - ориентированного подхода обратного реинжиниринга web - интерфейсов Статья посвящена применению <e1>рассуждений на основе прецедентов</e1> ( <e2>case - based reasoning</e2>, CBR ) в области web - разработки.	SYNONYMS
Показаны варианты применения системы для анализа генетического разнообразия клещей и переносимых ими патогенов при помощи методов статистической обработки в виде круговых и столбчатых диаграмм ( гистограмм ). Описаны реализованные алгоритмы, позволяющие проводить анализ <e2>генетической последовательности</e2> исследуемого патогена на основе L - граммного подхода и методами <e1>разбиения филогенетического дерева</e1> на группы близких последовательностей.	USAGE
Для этого в статье рассматриваются используемые в мире подходы по организации каталогов web - сервисов на основе SOAP ( Simple Object Access Protocol ) протокола, с использованием <e1>UDDI</e1> ( <e2>Universal Description Discovery and Integration</e2> ) реестров.	SYNONYMS
В результате МРС часто не обладает достаточным <e1>набором данных</e1> для составления <e2>рекомендаций</e2>.	USAGE
Представленные алгоритмы и методы <e1>использовались</e1> для решения задачи <e2>генотипирования вируса клещевого энцефалита</e2> ( ВКЭ ). Представлены результаты апробации для методов разбиения филогенетического дерева и их сравнительный анализ.	USAGE
Для <e2>адаптации интерфейсов</e2> используются <e1>модели пользователей</e1>, представляющие описания их потребностей, целей, интересов.	USAGE
Medilux – сервис интеллектуального формирования расписания посещений медицинских учреждений Предложен новый <e2>вид обслуживания</e2> – « <e1>интеллектуальная регистратура</e1> »: в мобильном приложении обеспечена возможность выбора сотрудников медицинского учреждения, далее происходит анализ графика работы выбранного врача и свободного времени пользователя при помощи алгоритмов программирования в ограничениях с целью определения наилучшего времени записи на прием.	ISA
Целью работы является разработка <e1>сервиса</e1>, позволяющего задавать <e2>сценарии представления стимулов</e2> с помощью графического интерфейса с возможностью сохранять метаинформацию эксперимента в независимом от платформы формате и исполнять в закрытых системах.	USAGE
В статье рассмотрены основные <e2>этапы работы системы</e2>, такие как предварительная обработка исходных данных ; расчет специальной матрицы подхода EMSICA, значения которой показывают уровень активности определенного участка мозга ; <e1>визуализация источников активности мозга</e1> на его трехмерной модели.	ISA
С помощью полученных <e1>шаблонов</e1> можно находить необходимую <e2>информацию</e2>, обрабатывая тексты естественного языка, представленные в Интернете.	TOOL
<e1>Java</e1> - достаточно старый язык, на нем написано большое количество <e2>императивного кода</e2>.	USAGE
Методика повышения производительности небольших информационных систем за счет оптимальной реструктуризации данных на основе многомодального распределения атрибутов Рассматривается <e1>системный подход</e1> к повышению <e2>производительности небольших информационных систем</e2> за счет оптимальной реструктуризации табличных структур данных.	CAUSE
<e1>Трехмерное моделирование</e1> и инверсия данных комплекса методов электрокаротажа в <e2>моделях сред</e2> с наклоном главных осей тензора электрической анизотропии Впервые формулируются прямая и обратная задачи электрического каротажа об определении компонент тензора электрической анизотропии горных пород по комплексу измерений методами бокового каротажного зондирования и бокового каротажа в нефтегазовых скважинах.	USAGE
Открытые решения веб - / видеоконференцсвязи и проект OpenMeetings Открытые программные решения веб - / видеоконференцсвязи анализируются как с <e1>технологической</e1>, так и с <e2>функциональной сторон</e2> в масштабе хорошо развитого ИТ - сегмента ВКС.	COMPARE
Разработанные решения включают в себя модели и механизмы сбора и хранения экспериментальных данных, <e1>модель</e1> для описания и <e2>формализации сценариев обработки данных</e2> и механизмы для обработки собранных данных в распределенной вычислительной системе.	USAGE
<e2>Параллельный алгоритм для численного моделирования встречных пучков ультра - релятивистских частиц</e2> с учетом <e1>угла встречи</e1> Представлен алгоритм для численного моделирования динамики пучков в суперколлайдерах.	USAGE
Математическое обоснование нового <e1>электромагнитного зонда</e1> с тороидальными катушками для <e2>высокоразрешающего каротажа нефтегазовых скважин</e2> Представленная работа посвящена обоснованию нового электромагнитного зонда для каротажа нефтегазовых скважин на основе компьютерного моделирования.	USAGE
В статье описан новый <e2>код</e2> « <e1>Виртуальный планетарий</e1> » для моделирования астрофизических объектов на основе метода SPH, дополненным методом Годунова для вычисления потоков давления и импульса между частицами, и методом быстрого преобразования Фурье для решения уравнения Пуассона для гравитационного потенциала.	ISA
Система предлагается в качестве инструмента для решения широкого спектра <e1>задач</e1>, возникающих при проведении b исследований и требующих <e2>сбора</e2>, хранения и многоэтапной обработки различных типов данных.	CAUSE
Расширение функциональности происходит через создание новых модулей <e1>и</e1> их добавление в систему <e2>.</e2>	PART_OF
Коллаборативная фильтрация для построения <e2>рекомендаций</e2> на основе <e1>данных о заказах</e1> Рассматривается возможность применения методов коллаборативной фильтрации в процессе создания рекомендательной системы на основе данных о заказах документов из библиотечного фонда.	USAGE
Такие <e1>структурные модели</e1> могут быть использованы для проверки различных <e2>статистических гипотез</e2> на сетях, в исследовании влияния структурных закономерностей в биологических сетях на их функцию и других задачах.	USAGE
Для решения задач геонавигации используются <e2>алгоритмы</e2>, основанные на <e1>методах корреляции каротажных данных</e1> и численной инверсии измерений электромагнитного каротажа.	USAGE
Обзор объектно - ориентированной парадигмы в приложении к разработке баз данных В статье приводится обзор проектов, технологий, <e1>программных продуктов</e1>, разрабатываемых для реализации идей <e2>объектно - ориентированного подхода</e2> к проектированию баз данных.	USAGE
Подход <e2>базируется</e2> на наборе MATLAB <e1>- скриптов</e1>, использующих библиотеки EEGLAB, NeuroElf, Alphasim, spm8, Mediation toolbox, и программном пакете sLORETA.	USAGE
Представлена общая <e1>схема верификации алгоритма управления</e1>, приведены ее реализация в автоматизированном варианте и результаты практической апробации в проекте по <e2>автоматизации Большого солнечного вакуумного телескопа</e2>.	USAGE
Система предлагается в качестве инструмента для решения широкого спектра <e1>задач</e1>, возникающих при проведении b исследований и требующих сбора, хранения и <e2>многоэтапной обработки</e2> различных типов данных.	CAUSE
Программа, реализующая адаптацию меню, состоит из двух модулей : <e2>модуль получения частот вызова услуг</e2> на основе <e1>запросов к онтологии</e1> и модуль оптимизации графа меню.	USAGE
Одним из возможных решений этой проблемы является использование эйлерово - лагранжева подхода, в котором физические величины сосредоточены в материальных точках, что характерно для метода SPH ( Smoothed Particle Hydrodynamics ), а <e2>расчет сил</e2> производится на <e1>адаптивной сетке</e1>, привязанной к системе материальных точек.	USAGE
В процессе исследования реализованы 2.0 вида <e2>нейронной сети</e2> : рекуррентный автоэнкодер и <e1>генеративно - состязательная сеть</e1>.	ISA
Проведен сравнительный анализ <e1>реляционного</e1> и <e2>графового подходов</e2> к хранению базовых сущностей.	COMPARE
<e2>Программный доступ</e2> к каждому модулю осуществляется при помощи <e1>gRPC</e1>.	USAGE
Их проблемой является сложность использования реализованного <e1>сценария</e1> как в рамках других <e2>систем</e2>, так и для аннотирования данных, полученных экспериментально.	USAGE
Научная значимость статьи обусловлена тем, что данная технология способствует созданию единого информационного пространства рынка работодателей по востребованным специальностям, а также активному налаживанию сотрудничества между вузами и работодателями с целью совершенствования <e2>механизма трудоустройства выпускников вузов</e2> на основе <e1>компетентностного подхода</e1>.	USAGE
Система предлагается в качестве инструмента для решения широкого спектра <e1>задач</e1>, возникающих при проведении b исследований и требующих сбора, <e2>хранения</e2> и многоэтапной обработки различных типов данных.	CAUSE
При <e1>взаимодействии высокоэнергетичных пучков</e1> возможна их <e2>деформация</e2> и разрушение, и изучение устойчивости пучка является актуальной задачей.	CAUSE
Для случая, если пользователь не знает, к кому обратиться, <e2>продукт</e2> снабжен « умным » <e1>чатом</e1>, в котором можно описать проблему.	PART_OF
Экспериментальное исследование эффективности предложенного <e1>алгоритма</e1> проводилось на <e2>временных рядах</e2> из M3 Competition и ряде T - индекса, при этом были использованы хорошо известные архиваторы.	USAGE
В этой работе мы описываем технологию переноса программного обеспечения, примененную к компилятору Clang ( и другим необходимым инструментам ) и предлагаем метод ускорения компиляции, <e1>автодополнения</e1> и анализа кода в нашей <e2>IDE</e2>.	PART_OF
В работе описан основанный на регулярных выражениях <e1>эвристический метод</e1> для <e2>генерации предкомпилированных заголовков</e2>, который имеет низкие требования к процессору и ОЗУ.	USAGE
Автоматическое извлечение решеток понятий из медицинских текстов на основе комбинации анализа формальных понятий и технологий бутстраппинга Рассматривается новый <e2>способ извлечения понятий</e2> из текстов предметной области на основе <e1>комбинации анализа формальных понятий</e1> и бутстрап - технологии информационного поиска.	USAGE
В качестве исходного <e2>хранилища публикаций</e2> использовалась <e1>база link. springer. com</e1>	ISA
Также учитываются ключевые слова, многословные термины и некоторые <e1>специальные слова</e1>, которые часто встречаются в <e2>научно - технических текстах</e2>.	PART_OF
Показаны варианты применения системы <e1>для</e1> анализа <e2>генетического разнообразия</e2> клещей и переносимых ими патогенов при помощи методов статистической обработки в виде круговых и столбчатых диаграмм ( гистограмм ). Описаны реализованные алгоритмы, позволяющие проводить анализ генетической последовательности исследуемого патогена на основе L - граммного подхода и методами разбиения филогенетического дерева на группы близких последовательностей.	TOOL
В статье описан новый код « Виртуальный планетарий » для <e2>моделирования астрофизических объектов</e2> на основе <e1>метода SPH</e1>, дополненным методом Годунова для вычисления потоков давления и импульса между частицами, и методом быстрого преобразования Фурье для решения уравнения Пуассона для гравитационного потенциала.	USAGE
Применение модельно - ориентированного проектирования к созданию АСУ ТП опасных промышленных объектов Представлена реализация <e1>подхода</e1> « модельно - ориентированного проектирования » для решения задачи создания <e2>автоматизированных систем управления технологическими процессами</e2> ( АСУ ТП ) горнодобывающих предприятий.	TOOL
Разработанный алгоритм <e1>с</e1> усложненной имитовставкой может найти применение в различных областях беспроводных <e2>систем безопасности</e2>, в которых требуется защита передаваемых по радиоканалу тревожных и служебных сообщений от несанкционированного доступа.	USAGE
Показаны варианты применения системы для анализа <e2>генетического разнообразия</e2> клещей и переносимых ими патогенов при помощи методов <e1>статистической обработки</e1> в виде круговых и столбчатых диаграмм ( гистограмм ). Описаны реализованные алгоритмы, позволяющие проводить анализ генетической последовательности исследуемого патогена на основе L - граммного подхода и методами разбиения филогенетического дерева на группы близких последовательностей.	USAGE
Для представления <e2>знаний</e2> используются фрагменты атомарных <e1>диаграмм алгебраических систем</e1> и нечеткие модели.	USAGE
Бинарные операции в информационной системе « Молекулярная спектроскопия » Представлен подход, использованный при разработке и реализации модуля, выполняющего <e1>бинарные операции</e1> над данными в <e2>ИС</e2> « Молекулярная спектроскопия ». Приводится формализация бинарных операций над наборами спектроскопических данных с учетом особенностей предметной области.	USAGE
<e1>Математическое моделирование упругопластических деформаций</e1> для задач образования и <e2>эволюции геологических трещин</e2> Представлена математическая модель упругопластических сред с учетом фазовых переходов между твердым телом, жидкостью и газом.	USAGE
Разработанные <e2>решения</e2> включают в себя модели и механизмы сбора и хранения экспериментальных данных, <e1>модель</e1> для описания и формализации сценариев обработки данных и механизмы для обработки собранных данных в распределенной вычислительной системе.	PART_OF
Некоторые подходы к хранению информации о книгообеспеченности учебного процесса высшего учебного заведения Рассматриваются три <e2>подхода к хранению информации</e2> о книгообеспеченности учебного процесса при различных вариантах интеграции автоматизированной библиотечной информационной системы ( АБИС ) с информационной системой вуза : внутри АБИС в формате RUSMARC, в виде реляционной базы данных, с использованием <e1>технологии OLAP</e1>.	USAGE
Обобщенный <e2>алгоритм защищенного информационного обмена</e2> для беспроводных систем безопасности с усложненной <e1>имитовставкой</e1> На основании обобщенного алгоритма защищенного информационного обмена для беспроводных систем безопасности и защищенного устройства управления группой роботов разработан обобщенный алгоритм защищенного информационного обмена с усложненной имитовставкой для беспроводных систем безопасности.	PART_OF
Разработка сервиса задания сценариев предъявления стимулов с использованием модельно - ориентированного подхода Современная <e2>физиология</e2> не может обойтись без <e1>методов количественного анализа данных</e1>.	USAGE
Строительными блоками создаваемых <e2>систем трансформации</e2> служат отдельные <e1>модули трансформации</e1>, упакованные в Docker - контейнеры.	PART_OF
Для <e2>представления знаний</e2> в формальном виде используются <e1>бескванторные предложения логики предикатов</e1>, а также язык OWL DL.	USAGE
Методика автоматического тестирования развивающегося веб - приложения Статья посвящена <e1>методике автоматизированного тестирования</e1>  <e2>системы автоматической оценки заданий</e2> по программированию NSUts.	USAGE
При анализе данных ЭЭГ возникает проблема решения <e2>обратной задачи электроэнцефалографии</e2> – <e1>локализации источников электрической активности мозга</e1>.	ISA
Для представления <e2>знаний</e2> используются фрагменты атомарных диаграмм алгебраических систем и нечеткие <e1>модели</e1>.	USAGE
В статье рассмотрены основные <e2>этапы работы системы</e2>, такие как предварительная обработка исходных данных ; <e1>расчет специальной матрицы подхода EMSICA</e1>, значения которой показывают уровень активности определенного участка мозга ; визуализация источников активности мозга на его трехмерной модели.	ISA
Анализируются преимущества и недостатки каждого подхода, приводятся примеры <e2>организации хранения данных</e2> ( <e1>поля RUSMARC</e1>, измерения и меры для кубов OLAP ).	ISA
<e1>Разреженность пользовательских оценок</e1> – одна из главных <e2>проблем исследования МРС</e2>.	ISA
<e2>Разработка методов семантического поиска</e2> в Интернете, основанных на <e1>древовидных лингвистических шаблонах</e1> Статья посвящена разработке методов поиска информации в Интернете.	USAGE
Описанный в данной работе <e1>подход</e1> к исследованию <e2>хаотичности передаваемых сигналов</e2>, основанный на комплексном применении известного математического аппарата методов нелинейной динамики, потенциально можно применять для исследования хаотичности передаваемых сигналов широкого класса систем защищенной связи на основе динамического хаоса.	TOOL
Также учитываются <e1>ключевые слова</e1>, многословные термины и некоторые специальные слова, которые часто встречаются в <e2>научно - технических текстах</e2>.	PART_OF
Поскольку направлением данной работы является нахождение похожих объектов, а также их <e2>классификация</e2> на основе <e1>информации о внешнем представлении объекта</e1>, то рассматриваются алгоритмы получения признаков объекта из его изображения.	USAGE
<e2>Формирование базового словаря жестов</e2> для естественного компьютерного бесконтактного <e1>интерфейса</e1> Исследуются возможности бесконтактных систем и интерфейсов, главные принципы работы с такими технологиями.	USAGE
Сytoscape – плагин для построения структурных моделей биологических сетей в виде случайных графов Современные методы экспериментальных исследований позволяют реконструировать различного типа <e2>биологические сети</e2>, включая генные и <e1>метаболические сети</e1>, сети интерактомики, сети коэкспрессии генов, сети заболеваний и т.	ISA
Показаны варианты применения системы для анализа генетического разнообразия клещей и переносимых ими патогенов при помощи методов статистической обработки в виде круговых и столбчатых диаграмм ( гистограмм ). Описаны реализованные алгоритмы <e1>,</e1> позволяющие проводить анализ <e2>генетической последовательности</e2> исследуемого патогена на основе L - граммного подхода и методами разбиения филогенетического дерева на группы близких последовательностей.	TOOL
Авторами настоящей статьи разрабатывается <e1>информационная система</e1> для <e2>автоматизации сбора</e2>, хранения и анализа данных, в качестве отправной точки для которой используются три задачи обработки данных из области физиологии.	USAGE
Программная система управления образовательным процессом ИТОС Статья посвящена описанию <e1>программной системы ИТОС</e1> ( индивидуальных траекторий обучения студентов ), предназначенной для <e2>автоматизации работы</e2> с основной образовательной программой ( ООП ) и соответствующим ей учебным планом.	USAGE
<e2>Разработка музыкальной рекомендательной системы</e2> на основе <e1>обработки метаданных контента</e1> Музыкальная рекомендательная система ( МРС ) помогает пользователям музыкальных стриминговых сервисов находить интересующий их музыкальный контент.	USAGE
Анализ показал, что оценочное <e2>покрытие кода</e2> данными <e1>тестами</e1> достаточно высоко, и потому методику можно считать эффективной и применять на схожих веб - приложениях.	USAGE
Соответственно, представляется перспективным <e2>улучшение качества входных данных</e2> за счет применения <e1>бутстраппинга</e1> – технологии, обеспечивающей интеллектуальный поиск фрагментированной информации в сети Интернет.	USAGE
Для этого в статье рассматриваются используемые в мире подходы по организации каталогов web - сервисов на основе <e2>SOAP</e2> ( Simple Object Access Protocol ) протокола, с использованием <e1>UDDI</e1> ( Universal Description Discovery and Integration ) реестров.	USAGE
Трехмерное моделирование и инверсия данных комплекса методов электрокаротажа в моделях сред с наклоном главных осей тензора электрической анизотропии Впервые формулируются прямая и обратная задачи электрического каротажа об <e2>определении компонент тензора электрической анизотропии горных пород</e2> по комплексу измерений <e1>методами бокового каротажного зондирования</e1> и бокового каротажа в нефтегазовых скважинах.	USAGE
Благодаря этому возможно использование существующего <e1>ПО</e1> для доступа к данным телеметрической системы, что позволяет снизить объем передаваемых данных в сравнении с <e2>ПО удаленных рабочих столов</e2>.	COMPARE
Коллаборативная фильтрация для построения рекомендаций на основе данных о заказах Рассматривается возможность применения <e1>методов коллаборативной фильтрации</e1> в процессе создания <e2>рекомендательной системы</e2> на основе данных о заказах документов из библиотечного фонда.	USAGE
При генерации структурных моделей в случайных графах могут быть зафиксированы следующие <e2>характеристики</e2> : распределение степеней вершин, попарное распределение степеней вершин, <e1>средняя степень соседних вершин</e1>, коэффициент кластеризации, спектр кластеризации, частота структурных мотивов различных размеров и др.	ISA
Автоматическое извлечение решеток понятий из медицинских текстов на основе комбинации анализа формальных понятий и технологий бутстраппинга Рассматривается новый <e1>способ извлечения понятий</e1> из <e2>текстов предметной области</e2> на основе комбинации анализа формальных понятий и бутстрап - технологии информационного поиска.	USAGE
Электромагнитное профилирование компактной аппаратурой : новый подход и результаты применения Современные <e1>портативные приборы</e1> для <e2>электромагнитного профилирования</e2> и малоглубинного зондирования позволяют изучать распределение удельного электрического сопротивления грунта.	USAGE
Описанный в данной работе <e2>подход</e2> к исследованию хаотичности передаваемых сигналов, основанный на комплексном применении известного <e1>математического аппарата</e1> методов нелинейной динамики, потенциально можно применять для исследования хаотичности передаваемых сигналов широкого класса систем защищенной связи на основе динамического хаоса.	USAGE
<e2>Метод проверки гипотез</e2> на базе <e1>статистической обработки разнородных электроэнцефалографических данных</e1> Предложен подход для автоматизации проверки гипотез на основе обработки разнородных ЭЭГ - данных.	USAGE
Применение методов нелинейной динамики для исследования хаотичности сигналов - переносчиков защищенных систем связи на основе динамического хаоса Исследуется хаотичность передаваемых сигналов защищенных систем связи на основе динамического хаоса с помощью распространенных <e2>методов нелинейной динамики</e2> ( максимальный показатель Ляпунова, <e1>показатель Хёрста</e1> и рекуррентные графики ). В качестве защищенной системы связи на основе динамического хаоса рассмотрено устройство имитозащиты контролируемых объектов с повышенной структурной скрытностью сигналов - переносчиков.	ISA
Данная <e1>методика</e1> успешно применена для <e2>разработки</e2>, отладки и тестирования АСКУ ТО М ( Автоматизированная система контроля и управления технологическим объектом во взрывозащищенном исполнении ).	USAGE
Прагматический уровень включает в себя исследования по автоматическому определению высокоуровневых <e2>характеристик поэтического текста</e2>, таких как жанр и стиль <e1>.</e1>	ISA
<e2>Процесс реферирования</e2> состоит из пяти основных шагов : <e1>предобработка</e1>, риторический анализ и преобразование текста, оценка весов, выбор предложений и сглаживание.	PART_OF
В данной работе предложен базирующийся на <e1>архиваторах</e1>  <e2>алгоритм прогнозирования временных рядов</e2> и проведено экспериментальное исследование его эффективности.	USAGE
В системе реализован алгоритм построения и оценки всевозможных индивидуальных траекторий обучения студента в рамках данной ООП, а также модуль рекомендательной системы, помогающей <e1>пользователям</e1> ( <e2>студентам</e2> ) в выборе индивидуальных траекторий обучения.	SYNONYMS
<e2>Подход</e2> основан на использовании <e1>математических моделей</e1>, имитирующих протекание технологического процесса под управлением АСУ ТП.	USAGE
В основу <e2>программного средства</e2> легла реализация <e1>протокола SSH</e1>, что обеспечило сжатие и шифрование передаваемых данных и прозрачный доступ к TCP - сервисам на буровой.	USAGE
<e2>Решение уравнения Пуассона</e2> для гравитационного потенциала выполняется с использованием <e1>быстрого преобразования Фурье</e1>.	USAGE
Электромагнитное профилирование компактной аппаратурой : новый подход и результаты применения Современные <e1>портативные приборы</e1> для электромагнитного профилирования и <e2>малоглубинного зондирования</e2> позволяют изучать распределение удельного электрического сопротивления грунта.	USAGE
<e2>Программа</e2>, реализующая адаптацию меню, состоит из двух модулей : модуль получения частот вызова услуг на основе запросов к онтологии и <e1>модуль оптимизации графа меню</e1>.	PART_OF
Важной частью <e2>алгоритма</e2> является <e1>автоматическое формирование трехмерных расчетных сетей</e1>, необходимых для расчета синтетических сигналов в моделях.	PART_OF
Разработка и реализация алгоритмов разрешения конфликтов по доступу к памяти в динамическом компиляторе Java для процессора « Эльбрус » Рассмотрены особенности разработки <e1>алгоритмов разрешения конфликтов по доступу к памяти</e1> и их реализация в динамическом компиляторе Java для отечественной <e2>платформы</e2> « Эльбрус ». Эти алгоритмы позволяют существенно расширить возможности планировщика инструкций – ключевой оптимизации VLIW - процессоров.	USAGE
Для решения этой задачи разработан <e2>модуль минерализации</e2>, состоящий из двух подмодулей : подмодуль измерения и регулирования pH и <e1>подмодуль измерения</e1> и регулирования EC.	PART_OF
В результате прототипирования создана оптимальная <e1>конструкция корпуса</e1>, позволяющая реализовать данный <e2>принцип компенсации</e2>.	USAGE
В качестве <e1>системы принятия решений</e1> в работе использована <e2>интеллектуальная система</e2> на основе нечеткой логики.	ISA
Система <e1>предназначена</e1> для анализа <e2>множества геномов</e2> и их классификации, а именно для анализа генотипов внутри одного вида живых организмов, поскольку методы направлены для выделения различий геномов, имеющих схожую структуру.	TOOL
<e1>Методологические аспекты применения инструментария ГИС</e1> для <e2>управления трудоустройством выпускников региональных вузов</e2> Целью данного исследования является совершенствование механизма трудоустройства выпускников вузов по специальностям с учётом нужд региона с использованием современных компьютерных технологий.	USAGE
В методике применяется известный шаблон проектирования Page Object и рассматривается ряд <e1>приемов</e1>, позволяющих снизить хрупкость разрабатываемых <e2>тестов</e2> и упростить их адаптацию для работы с новой версией системы.	USAGE
Данный <e1>алгоритм</e1> может быть использован для <e2>прогнозирования рядов</e2> с дискретными и непрерывными алфавитами.	USAGE
При этом для первичной обработки набора <e2>геномов</e2> используются методы <e1>множественного выравнивания последовательностей</e1> и метод присоединения соседей, позволяющий выполнить построение филогенетического дерева.	USAGE
Разработка и реализация <e1>алгоритмов разрешения конфликтов по доступу к памяти</e1> в динамическом компиляторе Java для <e2>процессора</e2> « Эльбрус » Рассмотрены особенности разработки алгоритмов разрешения конфликтов по доступу к памяти и их реализация в динамическом компиляторе Java для отечественной платформы « Эльбрус ». Эти алгоритмы позволяют существенно расширить возможности планировщика инструкций – ключевой оптимизации VLIW - процессоров.	USAGE
Бинарные операции в информационной системе « Молекулярная спектроскопия » Представлен подход, использованный при разработке и реализации модуля, выполняющего бинарные операции над данными в <e2>ИС</e2> « <e1>Молекулярная спектроскопия</e1> ». Приводится формализация бинарных операций над наборами спектроскопических данных с учетом особенностей предметной области.	ISA
Также были реализованы две параллельные версии алгоритма, проведены расчеты на различных многоядерных системах ( на классической многопроцессорной архитектуре, а также <e2>архитектуре</e2> с использованием <e1>сопроцессоров Intel Xeon Phi</e1> – " РСК ПетаСтрим "). Представлены сравнительные тесты ускорений на разных архитектурах, а также описаны особенности распараллеливания алгоритма.	USAGE
Основными частями <e2>комплекса</e2> являются : рабочая станция оператора SCADA, <e1>рабочая станция оператора модели</e1>, среда передачи данных, блок формирования физических сигналов, блок дублирования физических сигналов и программируемые логические контроллеры АСУ ТП.	PART_OF
Также учитываются ключевые слова, <e1>многословные термины</e1> и некоторые специальные слова, которые часто встречаются в <e2>научно - технических текстах</e2>.	PART_OF
В работе исследуются <e1>статические</e1> и динамические подходы к анализу <e2>зависимостей по памяти</e2>, и приводится сравнение эффективности реализованных алгоритмов на основе стандартной тестовой сюиты SpecJVM2008.	USAGE
В <e2>методике</e2> применяется известный <e1>шаблон проектирования Page Object</e1> и рассматривается ряд приемов, позволяющих снизить хрупкость разрабатываемых тестов и упростить их адаптацию для работы с новой версией системы.	USAGE
Сytoscape – плагин для построения структурных моделей биологических сетей в виде случайных графов Современные методы экспериментальных исследований позволяют реконструировать различного типа <e2>биологические сети</e2>, включая генные и метаболические сети, сети интерактомики, <e1>сети коэкспрессии генов</e1>, сети заболеваний и т.	ISA
<e1>Семантический подход</e1> к <e2>моделированию фонда оценочных средств</e2> Фонд оценочных средств является составной частью нормативно - методического обеспечения системы оценки качества освоения студентом учебного материала.	USAGE
<e1>Сytoscape</e1> – <e2>плагин</e2> для построения структурных моделей биологических сетей в виде случайных графов Современные методы экспериментальных исследований позволяют реконструировать различного типа биологические сети, включая генные и метаболические сети, сети интерактомики, сети коэкспрессии генов, сети заболеваний и т.	ISA
<e1>Атрибутная конвейерная модель</e1> для <e2>интерактивной визуализации объектных связей</e2> Определена модель для визуализации связей между объектами и их атрибутами в различных процессах.	USAGE
К типичным сферам применения подобных комплексов можно отнести : исследование археологических объектов – курганы, древние поселения ; решение экологических задач – изучение отвалов и хвостохранилищ горнодобывающих предприятий, зон распространения вредных веществ ; локализация <e2>инженерных объектов</e2> – труб и <e1>коммуникаций</e1>, исследование состояния дамб и плотин.	ISA
Разработанная <e2>система</e2> построена по архитектуре клиент - сервер и состоит из <e1>плагина Cytoscape</e1> и удаленного вычислительного сервиса.	PART_OF
В работе описан основанный на <e1>регулярных выражениях</e1>  <e2>эвристический метод</e2> для генерации предкомпилированных заголовков, который имеет низкие требования к процессору и ОЗУ.	USAGE
Programing Mobile Web Based for Adaptive Testing Рассматривается использование <e1>мобильных устройств</e1> для <e2>тестирования</e2> по сравнению с веб - системами оценки знаний.	USAGE
Результатом исследования являются методологические аспекты применения <e1>открытой геоинформационной системы QGIS</e1> для управления <e2>трудоустройством молодых специалистов</e2>.	USAGE
Разработана <e2>программная система</e2>, строящая оптимальное меню услуг для классов пользователей, разделенных по социально - экономическим и физическим параметрам, с использованием модифицированного <e1>алгоритма построения оптимального графа USSD - меню</e1>.	USAGE
Интеллектуальная система обработки и интеграции знаний на основе технологий семантической паутины Статья посвящена <e2>разработке методов извлечения</e2> из текстов естественного языка определений ключевых понятий предметной области на основе <e1>теоретико - модельного подхода</e1>.	USAGE
В основе <e2>моделирования</e2> этих компонент могут лежать совершенно разные <e1>классы численных методов</e1>.	USAGE
<e1>Теоретико - алгоритмическая база</e1> и компьютерное моделирование данных диэлектрического каротажа для изучения <e2>частотного спектра электрофизических параметров геологической среды</e2> Статья посвящена разработке теоретической базы компьютерного моделирования данных диэлектрического каротажа с целью обоснования нового импортозамещающего оборудования для каротажа нефтяных и газовых скважин.	TOOL
<e1>Программное обеспечение</e1> на основе WEB - технологий для <e2>геонавигации нефтегазовых скважин</e2> Для эффективного освоения залежей углеводородов чрезвычайно важной становится высокая точность проводки горизонтальных скважин в целевых пластах - коллекторах.	USAGE
Точное определение <e1>геометрии сосудов</e1> необходимо для построения <e2>гидродинамической модели кровоснабжения сердца</e2> и расчета параметров кровотока с помощью уравнений Навье – Стокса.	USAGE
Целью данной работы является объединение существующих реализаций алгоритмов, написанных на разных языках <e2>программирования</e2> ( С ++, Си, Python, Kotlin <e1>,</e1> Fortran и т.	ISA
При генерации структурных моделей в случайных графах могут быть зафиксированы следующие <e2>характеристики</e2> : распределение степеней вершин, попарное распределение степеней вершин, средняя степень соседних вершин, коэффициент кластеризации, <e1>спектр кластеризации</e1>, частота структурных мотивов различных размеров и др.	ISA
Сytoscape – плагин для построения структурных моделей биологических сетей в виде случайных графов Современные методы экспериментальных исследований позволяют реконструировать различного типа <e2>биологические сети</e2>, включая <e1>генные</e1> и метаболические сети, сети интерактомики, сети коэкспрессии генов, сети заболеваний и т.	ISA
<e1>Математические модели</e1> используются для <e2>формирования наборов тестовых данных</e2>.	USAGE
В этой работе используется один из таких подходов – <e1>EMSICA</e1> ( <e2>Electromagnetic Spatiotemporal Independent Component Analysis</e2> ), предложенный A.	SYNONYMS
В работе используется <e1>онтологический подход</e1> для <e2>формального представления понятий</e2> данной предметной области, извлечения, представления и обработки знаний.	USAGE
Предложенный в статье <e1>подход</e1> может быть полезен при построении рекомендательных систем и <e2>систем авто - реферирования</e2>.	USAGE
Основным недостатком метода <e2>,</e2> с точки зрения затрат по времени, является функция <e1>переупорядочивания частиц между ячейками</e1>.	PART_OF
Разработанные решения включают в себя модели и механизмы сбора и хранения экспериментальных данных, модель для описания и формализации сценариев обработки данных и <e1>механизмы</e1> для <e2>обработки</e2> собранных данных в распределенной вычислительной системе.	USAGE
Рассчитаны <e2>кластеры сайтов связывания транскрипционных факторов</e2> в геноме человека по <e1>базе данных Cistrome</e1>, построены матрицы совместной встречаемости пар сайтов связывания различных транскрипционных факторов в геноме для различных типов тканей и культур клеток.	USAGE
Разработанный инструментарий <e1>позволяет</e1> проводить унификацию ЭЭГ - записей, сделанных на различном оборудовании, восстановление утраченных данных, 3Dреконструкцию источников мозговой активности по исходным ЭЭГ - данным и медиационный <e2>анализ</e2>.	TOOL
В данной статье рассмотрен алгоритм <e1>,</e1> позволяющий уменьшить флуктуацию <e2>с</e2> учетом статистической зависимости соседних элементов спектра, для улучшения качественной оценки результатов исследования.	TOOL
Такие <e2>эксперименты</e2> требуют разработки новых <e1>компьютерных инструментов анализа объемных данных секвенирования</e1>.	USAGE
Для быстрого <e2>сравнения геномов</e2> с целью выявления повторяющихся наборов нуклеотидов разработана специализированная <e1>компьютерная система</e1>.	USAGE
Большинство <e1>сред разработки</e1> языка C ++ для <e2>Android</e2> не имеют автодополнения и анализа кода, в то время как остальные предоставляют эти возможности с крайне низкой производительностью.	USAGE
На основании оригинального принципа компенсации первичного поля генераторной катушки была разработана <e1>компактная многочастотная аппаратура</e1> для <e2>электромагнитного профилирования</e2>.	USAGE
<e2>Программа</e2>, реализующая адаптацию меню, состоит из двух <e1>модулей</e1> : модуль получения частот вызова услуг на основе запросов к онтологии и модуль оптимизации графа меню.	PART_OF
Разработанные <e2>решения</e2> включают в себя модели и механизмы сбора и хранения экспериментальных данных, модель для описания и формализации сценариев обработки данных и <e1>механизмы</e1> для обработки собранных данных в распределенной вычислительной системе.	PART_OF
Сравнительный анализ использования реляционных и <e1>графовых баз данных</e1> в разработке <e2>цифровых образовательных систем</e2> Рассмотрены вопросы выбора варианта реализации базы данных при разработке цифровых образовательных систем.	USAGE
Большинство <e2>сред разработки</e2> языка C ++ для Android не имеют автодополнения и <e1>анализа кода</e1>, в то время как остальные предоставляют эти возможности с крайне низкой производительностью.	PART_OF
<e2>Компьютерный анализ альтернативного сплайсинга генов</e2> в культурах клеток глиом по <e1>данным RNA - seq</e1> Современные постгеномные методы изучения экспрессии генов с помощью транскриптомного профилирования имеют большое значение для фундаментальных биомедицинских исследований в онкологии, поиска новых маркеров развития опухолей на культурах клеток глиом.	USAGE
Процесс построения шаблонов по данному фрагменту атомарной диаграммы выполняется в 2.0 <e2>этапа</e2> : 1.0 ) <e1>порождение простых шаблонов</e1> ; 2.0 ) с помощью полученных простых шаблонов создание более сложных или реже встречающихся шаблонов.	ISA
Алгоритм предобработки сигнала импульсного нейтронного гамма - каротажа с учетом статистической зависимости соседних элементов спектра На фоне множества методов <e2>проведения</e2> геофизических исследований выделяется и является одним из перспективных, за счет возможности определения состава горных пород, импульсный <e1>нейтронный гамма - каротаж</e1>.	ISA
Цель представленного исследования – <e2>компьютерный поиск генов</e2> и их изоформ, нарушение экспрессии которых связано с развитием глиобластом, с помощью современных высокопроизводительных <e1>технологий секвенирования транскриптом</e1> и международных биомедицинских банков данных.	USAGE
При генерации структурных моделей в случайных графах могут быть зафиксированы следующие <e2>характеристики</e2> : распределение степеней вершин, попарное распределение степеней вершин, средняя степень соседних вершин, коэффициент кластеризации, спектр кластеризации, <e1>частота структурных мотивов</e1> различных размеров и др.	ISA
Для решения задач геонавигации используются <e2>алгоритмы</e2>, основанные на методах корреляции каротажных данных и <e1>численной инверсии измерений электромагнитного каротажа</e1>.	USAGE
В настоящее время существует множество <e1>программных систем</e1>, позволяющих создавать, редактировать и запускать <e2>сценарии представления стимулов</e2>.	USAGE
Показаны варианты применения системы для анализа генетического разнообразия клещей и переносимых ими патогенов при помощи методов статистической обработки в виде круговых и столбчатых <e1>диаграмм</e1> ( гистограмм <e2>).</e2> Описаны реализованные алгоритмы, позволяющие проводить анализ генетической последовательности исследуемого патогена на основе L - граммного подхода и методами разбиения филогенетического дерева на группы близких последовательностей.	SYNONYMS
<e2>Автоматизация построения трехмерных геоэлектрических моделей</e2> для метода зонди - рования становлением поля в ближней зоне на основе результатов <e1>одномерной инверсии</e1> Предложен алгоритм автоматизации построения трехмерных геоэлектрических моделей для метода зондирования становлением поля в ближней зоне на основе результатов одномерной инверсии с целью расчета синтетических сигналов для трехмерных моделей, а также ускорения получения качественной оценки полевых материалов и сведения к минимуму ошибок интерпретации.	USAGE
В качестве <e2>платформы</e2> с открытым кодом для создания новых приложений был выбран <e1>CMF Drupal</e1>, который значительно облегчает разработку и перенос модели данных.	ISA
Необходимым условием для использования <e2>математической статистики</e2>, анализа сигналов и машинного обучения является наличие должным образом собранных, размеченных и <e1>подготовленных данных</e1>.	USAGE
Применение методов нелинейной динамики для исследования хаотичности сигналов - переносчиков защищенных систем связи на основе динамического хаоса Исследуется хаотичность передаваемых сигналов защищенных систем связи на основе динамического хаоса с помощью распространенных <e2>методов нелинейной динамики</e2> ( максимальный показатель Ляпунова, показатель Хёрста и <e1>рекуррентные графики</e1> ). В качестве защищенной системы связи на основе динамического хаоса рассмотрено устройство имитозащиты контролируемых объектов с повышенной структурной скрытностью сигналов - переносчиков.	ISA
В данной работе предложен иной <e2>подход к дискретизации области</e2> : <e1>построение криволинейной сетки</e1>, хорошо согласующейся с геометрией свободной поверхности.	ISA
Также были реализованы две параллельные версии алгоритма, проведены расчеты на различных многоядерных системах ( на классической многопроцессорной архитектуре, а также архитектуре с использованием сопроцессоров Intel Xeon Phi – " РСК ПетаСтрим "). Представлены <e2>сравнительные тесты ускорений</e2> на разных <e1>архитектурах</e1>, а также описаны особенности распараллеливания алгоритма.	USAGE
Цель данной работы – показать, что при правильном выборе исходных шаблонов поиска бутстраппинг, основанный на использовании открытых <e1>ресурсов Интернета</e1> как ценных <e2>источников знаний</e2>, превращается в эффективный инструмент поддержки концептуального моделирования.	ISA
Подход базируется на наборе MATLAB <e2>- скриптов</e2>, использующих библиотеки EEGLAB <e1>,</e1> NeuroElf, Alphasim, spm8, Mediation toolbox, и программном пакете sLORETA.	USAGE
<e2>Локализация источников активности мозга</e2> на его трехмерной модели при помощи <e1>совместного анализа данных ЭЭГ / cМРТ</e1> Несмотря на большое количество существующих методов диагностики головного мозга, он остается наименее изученной частью человеческого организма.	USAGE
При генерации структурных моделей в случайных графах могут быть зафиксированы следующие <e2>характеристики</e2> : <e1>распределение степеней вершин</e1>, попарное распределение степеней вершин, средняя степень соседних вершин, коэффициент кластеризации, спектр кластеризации, частота структурных мотивов различных размеров и др.	ISA
Сравнительный анализ использования <e1>реляционных</e1> и <e2>графовых баз данных</e2> в разработке цифровых образовательных систем Рассмотрены вопросы выбора варианта реализации базы данных при разработке цифровых образовательных систем.	COMPARE
Экспериментальное исследование точности методов прогноза, базирующихся на архиваторах В теории информации известно, что <e1>методы сжатия данных</e1> могут быть использованы для <e2>прогнозирования стационарных процессов</e2>.	USAGE
Анализируются преимущества и недостатки каждого подхода, приводятся примеры <e2>организации хранения данных</e2> ( поля RUSMARC, измерения и меры для <e1>кубов OLAP</e1> ).	USAGE
Экспериментальное исследование эффективности предложенного алгоритма проводилось на <e1>временных рядах</e1> из <e2>M3 Competition</e2> и ряде T - индекса, при этом были использованы хорошо известные архиваторы.	PART_OF
С использованием разработанной системы проведен вычислительный эксперимент по <e2>реконструкции структурных моделей ряда биологических сетей</e2>, для которых удалось построить <e1>алгоритм предсказания времени расчетов структурных моделей</e1>.	USAGE
Модели и проектные решения системы хранения и обработки исследовательских данных Ecclesia В ходе научных исследований порождается большое количество данных в цифровом формате, и для после - дующего использования этих <e1>данных</e1> ( <e2>обработки</e2>, анализа, публикации ) их необходимо организованно собирать и хранить.	USAGE
Продолжение работы может быть в направлениях : 1.0 ) решения задачи об определении момента, когда необходимо добавлять узел к кластеру при возрастании рассматриваемого количества выбранных наборов нуклеотидов и увеличении числа геномов в БД организмов ; 2.0 ) практического наполнения создаваемой БД как можно большим количеством реальных геномов организмов ; 3.0 ) исследования <e1>геномных нарушений</e1> с целью оценки вероятности <e2>генетических отклонений</e2> на этапе распознавания потенциально возможного неблагоприятного развития организма.	CAUSE
В статье описан новый <e1>код</e1> « Виртуальный планетарий » для <e2>моделирования астрофизических объектов</e2> на основе метода SPH, дополненным методом Годунова для вычисления потоков давления и импульса между частицами, и методом быстрого преобразования Фурье для решения уравнения Пуассона для гравитационного потенциала.	USAGE
В процессе исследования реализованы 2.0 вида <e2>нейронной сети</e2> : <e1>рекуррентный автоэнкодер</e1> и генеративно - состязательная сеть.	ISA
Несмотря на то что цунами <e1>довольно</e1> редкое явление <e2>,</e2> его последствия могут быть катастрофическими.	ISA
Целью данной работы является объединение существующих реализаций алгоритмов, написанных на разных языках <e2>программирования</e2> ( С <e1>++,</e1> Си, Python, Kotlin, Fortran и т.	ISA
<e1>Методика автоматического тестирования</e1> развивающегося <e2>веб - приложения</e2> Статья посвящена методике автоматизированного тестирования системы автоматической оценки заданий по программированию NSUts.	USAGE
<e2>Автоматическое извлечение решеток понятий</e2> из медицинских текстов на основе комбинации анализа формальных понятий и <e1>технологий бутстраппинга</e1> Рассматривается новый способ извлечения понятий из текстов предметной области на основе комбинации анализа формальных понятий и бутстрап - технологии информационного поиска.	USAGE
Предложенный <e2>алгоритм</e2> может быть реализован на <e1>ЭВМ</e1>.	USAGE
<e2>Адаптация структуры меню услуг</e2> для различных типов пользователей с применением <e1>онтологического моделирования</e1> Статья посвящена решению проблемы адаптации больших древовидных и линейных меню мобильных и интернет - услуг для различных типов пользователей на основании их интересов, социального статуса, а также иных параметров.	USAGE
Разработанные решения включают в себя модели и механизмы сбора и хранения экспериментальных данных, <e1>модель</e1> для <e2>описания</e2> и формализации сценариев обработки данных и механизмы для обработки собранных данных в распределенной вычислительной системе.	USAGE
Представлен <e2>прототип базы данных дифференциального альтернативного сплайсинга генов</e2> – « <e1>Дифференциальный альтернативный сплайсинг генов человека при вторичной глиобластоме</e1> ( ДАСГГ )», с возможностью работы через веб - сайт, поиска уровней экспрессии отдельных изоформ в глиальной опухоли	ISA
Предложен алгоритм численного моделирования на основе <e2>численного решения линейной 2D - системы теории упругости</e2>, записанной в смещениях, с использованием <e1>криволинейной сетки</e1> и пошагового метода Лагерра.	USAGE
<e1>Коллаборативная фильтрация</e1> для построения <e2>рекомендаций</e2> на основе данных о заказах Рассматривается возможность применения методов коллаборативной фильтрации в процессе создания рекомендательной системы на основе данных о заказах документов из библиотечного фонда.	USAGE
Проведен сравнительный анализ реляционного и <e1>графового подходов</e1> к <e2>хранению базовых сущностей</e2>.	USAGE
Основными частями <e2>комплекса</e2> являются : рабочая станция оператора SCADA, рабочая станция оператора модели, <e1>среда передачи данных</e1>, блок формирования физических сигналов, блок дублирования физических сигналов и программируемые логические контроллеры АСУ ТП.	PART_OF
При этом для первичной обработки набора геномов используются методы множественного выравнивания последовательностей и метод <e1>присоединения соседей</e1>, позволяющий выполнить построение филогенетического <e2>дерева</e2>.	TOOL
Компьютерная база данных для анализа дифференциально экспрессирующихся генов, связанных с агрессивным поведением, на моделях лабораторных животных Разработка и применение <e1>компьютерных средств анализа транскриптомных данных</e1> в <e2>модельных организмах животных</e2> представляет актуальную задачу биоинформатики.	USAGE
В статье рассмотрены основные этапы работы системы <e2>,</e2> такие как мониторинг сейсмической активности, извлечение данных с DART станций, фильтрация приливной компоненты, расчет времени добегания волны и непосредственно моделирование <e1>,</e1> и промежуточные шаги, связанные с предобработкой и трансформацией данных.	PART_OF
<e2>Подход</e2> « <e1>модельно - ориентированного проектирования</e1> » заключается в организации контура тестирования, в котором испытуемый объект функционирует в среде, идентичной реальному процессу по входным сигналам.	ISA
На основе предложенного <e1>метода</e1> создана <e2>система</e2>, позволяющая получать краткие аннотации научно - технических текстов и определять их темы.	USAGE
Методологические аспекты применения инструментария ГИС для управления трудоустройством выпускников региональных вузов Целью данного исследования является совершенствование <e2>механизма трудоустройства выпускников вузов</e2> по специальностям с учётом нужд региона с использованием современных <e1>компьютерных технологий</e1>.	USAGE
Каждый информационный слой представлен таблицей реляционной базы данных или <e2>электронной таблицей</e2>, в которых имеется <e1>поле привязки к географическому местоположению</e1>, что позволяет разместить данные на карте.	PART_OF
На основе результатов проведенного <e1>анализа</e1> предложен ряд моделей и <e2>механизмов</e2> для решения возникших проблем.	CAUSE
<e2>Программное обеспечение</e2> на основе <e1>WEB - технологий</e1> для геонавигации нефтегазовых скважин Для эффективного освоения залежей углеводородов чрезвычайно важной становится высокая точность проводки горизонтальных скважин в целевых пластах - коллекторах.	USAGE
<e1>Система анализа</e1> и визуализации для <e2>кросс - языковой идентификации авторов</e2> научных публикаций Представлена система разрешения неоднозначности авторства статей на английском языке с использованием русскоязычных источников данных.	USAGE
В результате представлена <e1>архитектура вычислительной системы</e1> для <e2>сбора</e2>, хранения и обработки экспериментальных данных.	USAGE
Программы статистической обработки, кластеризации и <e1>визуализации</e1> распределения <e2>сайтов связывания транскрипционных факторов</e2> в геноме Исследование регуляции транскрипции генов на основе данных современных технологий высокопроизводительного секвенирования является актуальной задачей биоинформатики, требующей развития новых компьютерных средств, в том числе на основе суперкомпьютерных вычислений.	USAGE
Метод повышения робастных свойств линейной замкнутой системы в условиях структурно - параметрической неопределенности описания передаточной функции объекта управления Для <e2>линейных систем управления</e2>, состоящих из объекта управления со структурно - параметрической неопределенностью в описании и модального регулятора, обоснована <e1>мера робастных свойств устойчивости</e1> и качества управления.	USAGE
Практическая ценность продукта заключается в <e1>автоматизации бизнес - процесса</e1> « прием пациентов », что приводит к экономии времени пациентов, обеспечению высокой <e2>доступности услуг</e2> и оптимизации трудовых затрат в медучреждениях.	CAUSE
Получено решение прямой задачи <e1>электромагнитного каротажа</e1> для <e2>тороидального источника</e2> в цилиндрически - слоистой геоэлектрической модели.	USAGE
Для этого в статье рассматриваются используемые в мире подходы по организации каталогов web - сервисов на основе <e1>SOAP</e1> ( <e2>Simple Object Access Protocol</e2> ) протокола, с использованием UDDI ( Universal Description Discovery and Integration ) реестров.	SYNONYMS
Системы автоматизированной оценки заданий по программированию : разработка, использование и перспективы В статье приведен обзор существующих <e1>систем проверки заданий по программированию</e1>, кратко описано современное состояние архитектуры системы NSUts, созданной в Новосибирском государственном университете, и практика ее использования в <e2>учебном процессе</e2> и в олимпиадах по программированию различного уровня.	USAGE
Предложен <e2>алгоритм численного моделирования</e2> на основе <e1>численного решения линейной 2D - системы теории упругости</e1>, записанной в смещениях, с использованием криволинейной сетки и пошагового метода Лагерра.	USAGE
Поиск <e2>генов – кандидатов</e2> для терапевтического воздействия в опухолях, в том числе отдельных <e1>изоформ генов</e1>, актуален в здравоохранении и современной высокотехнологичной медицине.	ISA
<e1>Система каталогизации</e1> и мониторинга территориально распределенных вычислительных узлов в среде WPS сервисов для решения <e2>геологических задач</e2> Данная работа посвящена разработке подхода к каталогизации разнородных web - сервисов территориально распределенных вычислительных узлов в вычислительно - аналитической геологической среде, а также принципов по созданию системы мониторинга web - сервисов, присутствующих в каталоге.	USAGE
Применение FPGA для ускорения расчета волнового фронта цунами Рассматривается вопрос <e2>ускорения численного расчёта распространения волны цунами</e2> от очага до берега в рамках дифференциальной модели мелкой воды с применением <e1>аппаратного ускорения</e1> на базе FPGA.	USAGE
Проведен <e2>вычислительный эксперимент</e2> по компьютерной генерации случайных кластеров в геноме, а также <e1>оценке встре - чаемости кластеров</e1> большого размера для экспериментально полученных сайтов связывания транскрипционных факторов в геноме человека.	ISA
Для этого в статье рассматриваются используемые в мире подходы по организации каталогов web - сервисов на основе <e1>SOAP</e1> ( Simple Object Access Protocol ) <e2>протокола</e2>, с использованием UDDI ( Universal Description Discovery and Integration ) реестров.	ISA
Их проблемой является сложность использования реализованного <e1>сценария</e1> как в рамках других систем, так и для <e2>аннотирования данных</e2>, полученных экспериментально.	USAGE
Разработка и реализация алгоритмов разрешения конфликтов по доступу к памяти в динамическом компиляторе Java для процессора « Эльбрус » Рассмотрены особенности разработки алгоритмов разрешения конфликтов по доступу к памяти и их реализация в динамическом компиляторе Java для отечественной платформы « Эльбрус ». Эти <e1>алгоритмы</e1> позволяют существенно расширить возможности <e2>планировщика инструкций</e2> – ключевой оптимизации VLIW - процессоров.	USAGE
Извлеченная из текстов информация путем преобразования через <e2>фрагменты атомарных диаграмм алгебраических систем</e2> представляется в виде <e1>утверждений</e1> в логике описаний ( DL ). Подобное представление позволяет получать тексты с большей выразительностью по сравнению с алгоритмами, где источником информации являются данные, представленные в виде баз данных или в виде выражений на формализованных языках ( например, SQL ).	TOOL
Для <e2>представления знаний</e2> в формальном виде используются бескванторные предложения логики предикатов, а также <e1>язык OWL DL</e1>.	USAGE
Использование <e1>речевых действий</e1> позволяет задавать <e2>контекст диалога</e2> и уточнять смысл употребляемых понятий.	TOOL
<e2>Задача исследования экспрессии генов</e2> современными <e1>методами высокопроизводительного секвенирования</e1> в отделах мозга лабораторных животных является исключительно важной для изучения генетических основ поведения в целом.	USAGE
Представлен прототип базы данных дифференциального альтернативного сплайсинга генов – « <e1>Дифференциальный альтернативный сплайсинг генов человека при вторичной глиобластоме</e1> ( <e2>ДАСГГ</e2> )», с возможностью работы через веб - сайт, поиска уровней экспрессии отдельных изоформ в глиальной опухоли	SYNONYMS
Перспективной сферой являются объекты агропромышленного комплекса – оценка <e2>плодородности почв</e2> ( <e1>распределение минерализации</e1> ), контроль эффективности мелиорации.	PART_OF
Цель данной работы – показать, что при правильном выборе исходных шаблонов поиска <e2>бутстраппинг</e2>, основанный на использовании открытых <e1>ресурсов Интернета</e1> как ценных источников знаний, превращается в эффективный инструмент поддержки концептуального моделирования.	USAGE
В статье предлагается подход получения определяющих признаков объекта на основе его <e1>внешнего представления</e1> ( <e2>контуров</e2> ).	SYNONYMS
Система предназначена для анализа множества геномов и их классификации, а именно для анализа генотипов внутри одного вида живых организмов, поскольку методы <e1>направлены</e1> для выделения различий геномов <e2>,</e2> имеющих схожую структуру.	TOOL
В последнее время большинство экзаменационных комиссий используют <e1>компьютерное адаптивное тестирование</e1> ( CAT ) в качестве <e2>метода широкомасштабного тестирования</e2>.	ISA
Трехмерное моделирование и инверсия данных комплекса методов электрокаротажа в моделях сред с наклоном главных осей тензора электрической анизотропии Впервые формулируются прямая и обратная задачи электрического каротажа об <e2>определении компонент тензора электрической анизотропии горных пород</e2> по <e1>комплексу измерений</e1> методами бокового каротажного зондирования и бокового каротажа в нефтегазовых скважинах.	USAGE
Применение методов нелинейной динамики для исследования хаотичности сигналов - переносчиков защищенных систем связи на основе динамического хаоса Исследуется хаотичность передаваемых сигналов защищенных систем связи на основе динамического хаоса с помощью распространенных методов нелинейной динамики ( максимальный показатель Ляпунова, показатель Хёрста и рекуррентные графики ). В качестве <e2>защищенной системы связи</e2> на основе <e1>динамического хаоса</e1> рассмотрено устройство имитозащиты контролируемых объектов с повышенной структурной скрытностью сигналов - переносчиков.	USAGE
Разработка и реализация алгоритмов разрешения конфликтов по доступу к памяти в динамическом компиляторе Java для процессора « Эльбрус » Рассмотрены особенности разработки алгоритмов разрешения конфликтов по доступу к памяти и их реализация в динамическом компиляторе Java для отечественной платформы « Эльбрус ». Эти алгоритмы позволяют существенно расширить возможности <e2>планировщика инструкций</e2> – ключевой <e1>оптимизации</e1> VLIW - процессоров.	ISA
Разработанная <e2>система</e2> построена по архитектуре клиент - сервер и состоит из плагина Cytoscape и <e1>удаленного вычислительного сервиса</e1>.	PART_OF
Проведен эксперимент, подтверждающий эффективность разработанной <e1>методики</e1> для небольших <e2>информационных систем</e2>.	USAGE
Особое внимание уделяется разработке архитектуры системы, взаимодействие между модулями построено таким образом, чтобы в дальнейшем реализации алгоритмов <e1>могли</e1> дорабатываться и беспрепятственно встраиваться в систему <e2>.</e2>	PART_OF
<e2>Процесс реферирования</e2> состоит из пяти основных шагов : предобработка, <e1>риторический анализ</e1> и преобразование текста, оценка весов, выбор предложений и сглаживание.	PART_OF
Целью данной работы является объединение существующих реализаций алгоритмов, написанных на разных языках <e2>программирования</e2> ( С ++, Си, Python, Kotlin, Fortran <e1>и</e1> т.	ISA
Подход базируется на наборе MATLAB <e2>- скриптов</e2>, использующих библиотеки EEGLAB, NeuroElf, Alphasim, spm8 <e1>,</e1> Mediation toolbox, и программном пакете sLORETA.	USAGE
<e1>Автоматизированная верификация алгоритмов управления сложными технологическими объектами</e1> на <e2>программных имитаторах</e2> Статья посвящена проблеме проверки алгоритмов управления, созданных в рамках процесс - ориентированного подхода, на соответствие входным спецификациям.	USAGE
Под <e2>расширенной моделью</e2> понимается тематическая модель, содержащая кроме однословных терминов <e1>термины</e1>, состоящие из нескольких слов ( также называемые многословные термины или ключевые фра зы ). Такие модели лучше интерпретируются пользователями и точнее описывают предметную область документа, чем модели, состоящие только из униграмм ( отдельных слов ). На основе предложенного подхода была разработана система, в результате работы которой для каждого документа предоставляется набор содержащихся в нем тем с указанными вероятностями, ключевыми словами и фразами для каждой темы.	PART_OF
Цель представленного исследования – компьютерный поиск генов и их изоформ, <e2>нарушение экспрессии</e2> которых связано с развитием <e1>глиобластом</e1>, с помощью современных высокопроизводительных технологий секвенирования транскриптом и международных биомедицинских банков данных.	CAUSE
Взаимодействие между клиентом и сервером реализовано посредством <e2>фреймворка gRPC</e2> с применением <e1>протокола сериализации структурированных данных Protocol Buffers</e1>.	USAGE
Для оперативности запуска пользователю доступен виджет <e1>,</e1> который можно разместить на экране <e2>устройства</e2>.	PART_OF
Подход базируется на наборе MATLAB <e2>- скриптов</e2>, использующих библиотеки EEGLAB, NeuroElf, Alphasim <e1>,</e1> spm8, Mediation toolbox, и программном пакете sLORETA.	USAGE
Путем масштабного <e1>компьютерного моделирования</e1> выполнено обоснование <e2>оптимальной конфигурации зондовой системы</e2> и исследованы ее возможности изучения макроанизотропных свойств геологических сред.	USAGE
В статье описан новый код « Виртуальный планетарий » для моделирования астрофизических объектов на основе метода SPH, дополненным методом Годунова для вычисления потоков давления и импульса между частицами, и <e1>методом быстрого преобразования Фурье</e1> для <e2>решения уравнения Пуассона</e2> для гравитационного потенциала.	USAGE
Одно из возможных применений результатов данного исследования заключается в использовании разработанной <e1>программной системы</e1> при создании <e2>чат - ботов</e2>.	TOOL
Разработка <e1>среды программирования</e1> для <e2>мобильных устройств</e2> под управлением операционной системы Android Мобильные устройства часто используются для образовательных целей, учитывая их высокую доступность и портативность.	USAGE
Система предлагается в качестве инструмента для решения широкого спектра <e2>задач</e2>, возникающих при проведении <e1>b исследований</e1> и требующих сбора, хранения и многоэтапной обработки различных типов данных.	CAUSE
<e2>Процесс построения шаблонов</e2> по данному <e1>фрагменту атомарной диаграммы</e1> выполняется в 2.0 этапа : 1.0 ) порождение простых шаблонов ; 2.0 ) с помощью полученных простых шаблонов создание более сложных или реже встречающихся шаблонов.	USAGE
Семантический подход к моделированию фонда оценочных средств <e1>Фонд оценочных средств</e1> является составной частью <e2>нормативно - методического обеспечения системы оценки качества освоения</e2> студентом учебного материала.	PART_OF
Применение метода K - средних для идентификации пользователя по клавиатурному почерку В данной статье рассматривается проблема защиты от несанкционированного доступа к данным путем <e2>идентификации пользователей</e2> по <e1>биометрическим характеристикам</e1>, а именно, клавиатурному почерку.	USAGE
В статье рассматриваются преимущества и методологические аспекты применения инструментария географических информационных систем, которые являются симбиозом возможностей управления большими базами данных и пространственной визуализации, характерной для <e2>топографических карт</e2> с использованием <e1>QGIS</e1>.	USAGE
Для этого в статье рассматриваются используемые в мире подходы по организации каталогов web - сервисов на основе SOAP ( Simple Object Access Protocol ) протокола, с использованием <e1>UDDI</e1> ( Universal Description Discovery and Integration ) <e2>реестров</e2>.	ISA
В основе <e2>платформенно - независимой модели</e2> лежит открытый формат <e1>эксперимента PsychoPy</e1>.	USAGE
<e1>Программы статистической обработки</e1>, кластеризации и визуализации распределения <e2>сайтов связывания транскрипционных факторов</e2> в геноме Исследование регуляции транскрипции генов на основе данных современных технологий высокопроизводительного секвенирования является актуальной задачей биоинформатики, требующей развития новых компьютерных средств, в том числе на основе суперкомпьютерных вычислений.	USAGE
Также проведена апробация <e1>компонента</e1> для решения прикладной задачи по <e2>извлечению информации</e2> из документов.	USAGE
Разработанные <e2>решения</e2> включают в себя модели и <e1>механизмы сбора и хранения экспериментальных данных</e1>, модель для описания и формализации сценариев обработки данных и механизмы для обработки собранных данных в распределенной вычислительной системе.	PART_OF
При <e1>взаимодействии высокоэнергетичных пучков</e1> возможна их деформация и <e2>разрушение</e2>, и изучение устойчивости пучка является актуальной задачей.	CAUSE
Адаптация структуры меню услуг для различных типов пользователей с применением онтологического моделирования Статья посвящена решению проблемы <e2>адаптации больших древовидных и линейных меню</e2> мобильных и интернет - услуг для различных типов пользователей на основании их интересов, социального статуса, а также иных <e1>параметров</e1>.	USAGE
Электромагнитное профилирование компактной аппаратурой : новый подход и результаты применения Современные <e1>портативные приборы</e1> для электромагнитного профилирования и малоглубинного зондирования позволяют изучать <e2>распределение удельного электрического сопротивления грунта</e2>.	TOOL
Чтобы тестировать не только серверную, но и клиентскую часть веб - приложения, мы предлагаем использовать <e2>инструменты</e2> типа <e1>Selenium WebDriver</e1> для симуляции действий пользователей, посылая команды настоящим браузерам.	ISA
Работа основана на теоретико <e1>- модельном подходе</e1> к представлению <e2>знаний</e2>.	USAGE
Бинарные операции в информационной системе « Молекулярная спектроскопия » Представлен <e1>подход</e1>, использованный при разработке и реализации <e2>модуля</e2>, выполняющего бинарные операции над данными в ИС « Молекулярная спектроскопия ». Приводится формализация бинарных операций над наборами спектроскопических данных с учетом особенностей предметной области.	USAGE
Programing Mobile Web Based for Adaptive Testing Рассматривается использование <e1>мобильных устройств</e1> для тестирования по сравнению с <e2>веб - системами оценки знаний</e2>.	COMPARE
Формирование базового словаря жестов для естественного компьютерного бесконтактного интерфейса Исследуются возможности бесконтактных систем и интерфейсов, главные <e2>принципы</e2> работы с <e1>такими</e1> технологиями.	PART_OF
Для повышения <e2>точности прогноза</e2> возможно применение существующих <e1>методов предварительной обработки данных</e1>.	TOOL
Интеллектуальная система обработки и интеграции знаний на основе технологий семантической паутины Статья посвящена разработке методов извлечения из <e2>текстов естественного языка</e2>  <e1>определений ключевых понятий</e1> предметной области на основе теоретико - модельного подхода.	PART_OF
Предложен и реализован вариант развития <e1>способа Hardware - in - the - loop</e1>, обеспечивающего создание <e2>совместимых компонентов систем автоматизации</e2>.	TOOL
Методика повышения производительности небольших информационных систем за счет <e2>оптимальной реструктуризации данных</e2> на основе <e1>многомодального распределения атрибутов</e1> Рассматривается системный подход к повышению производительности небольших информационных систем за счет оптимальной реструктуризации табличных структур данных.	USAGE
Извлеченная из текстов информация путем преобразования через фрагменты атомарных диаграмм алгебраических систем представляется в виде утверждений в <e1>логике описаний</e1> ( <e2>DL</e2> ). Подобное представление позволяет получать тексты с большей выразительностью по сравнению с алгоритмами, где источником информации являются данные, представленные в виде баз данных или в виде выражений на формализованных языках ( например, SQL ).	SYNONYMS
Использование <e1>речевых действий</e1> позволяет задавать контекст диалога и уточнять <e2>смысл</e2> употребляемых понятий.	TOOL
Разработка методов интеграции автоматических средств логического вывода для порождения знаний в онтологической модели Статья посвящена <e2>разработке методов порождения новых знаний</e2> на основе <e1>анализа текстов естественного языка</e1>.	USAGE
Целью данной работы является объединение существующих реализаций алгоритмов, написанных на разных языках <e2>программирования</e2> ( С ++, Си, Python <e1>,</e1> Kotlin, Fortran и т.	ISA
<e2>Процесс реферирования</e2> состоит из пяти основных шагов : предобработка, риторический анализ и преобразование текста, оценка весов, <e1>выбор предложений</e1> и сглаживание.	PART_OF
На основании оригинального <e1>принципа компенсации первичного поля генераторной катушки</e1> была разработана <e2>компактная многочастотная аппаратура</e2> для электромагнитного профилирования.	USAGE
Обобщенный алгоритм защищенного информационного обмена для беспроводных систем безопасности с усложненной имитовставкой На основании обобщенного алгоритма защищенного информационного обмена для беспроводных систем безопасности и защищенного устройства управления группой роботов разработан обобщенный алгоритм <e1>защищенного информационного обмена</e1> с усложненной имитовставкой для беспроводных <e2>систем безопасности</e2>.	USAGE
Проведенные <e2>полевые испытания</e2> на известных <e1>объектах электрометрического полигона</e1> ИНГГ СО РАН, при поиске локальных и протяженных проводников, а также археолого - геофизические исследования показывают эффективность реализации компактной аппаратуры электромагнитного профилирования.	USAGE
Математическое обоснование нового <e2>электромагнитного зонда</e2> с <e1>тороидальными катушками</e1> для высокоразрешающего каротажа нефтегазовых скважин Представленная работа посвящена обоснованию нового электромагнитного зонда для каротажа нефтегазовых скважин на основе компьютерного моделирования.	PART_OF
Для исполнения полученного <e2>сценария</e2> используется <e1>платформа Neurobs Presentation</e1>.	USAGE
Так как спектры сигнала являются случайными величинами, в ходе рассмотрения различных способов обработки спектров решено применять функции <e2>сглаживания</e2>, а именно B <e1>- сплайн</e1>.	ISA
Для этого в статье рассматриваются используемые в мире подходы по <e2>организации каталогов web - сервисов</e2> на основе <e1>SOAP</e1> ( Simple Object Access Protocol ) протокола, с использованием UDDI ( Universal Description Discovery and Integration ) реестров.	USAGE
Знания, извлеченные из текстов, формализуются при помощи <e2>атомарных предложений сигнатуры</e2>, состоящей из символов констант, двухместных предикатов и <e1>дополнительных констант - ситуаций</e1>.	PART_OF
Для решения этой задачи разработан <e2>модуль минерализации</e2>, состоящий из двух <e1>подмодулей</e1> : подмодуль измерения и регулирования pH и подмодуль измерения и регулирования EC.	PART_OF
Коллаборативная фильтрация для построения рекомендаций на основе данных о заказах Рассматривается возможность применения методов коллаборативной фильтрации в процессе создания <e2>рекомендательной системы</e2> на основе <e1>данных о заказах документов</e1> из библиотечного фонда.	USAGE
Практическая ценность <e1>продукта</e1> заключается в <e2>автоматизации бизнес - процесса</e2> « прием пациентов », что приводит к экономии времени пациентов, обеспечению высокой доступности услуг и оптимизации трудовых затрат в медучреждениях.	USAGE
Подход базируется на наборе MATLAB <e2>- скриптов</e2>, использующих библиотеки EEGLAB, NeuroElf, Alphasim, spm8, Mediation <e1>toolbox</e1>, и программном пакете sLORETA.	USAGE
<e2>Формализация поведения пользователей</e2> осуществляется при помощи <e1>онтологической модели мобильных и интернет - услуг</e1>.	USAGE
Применение <e1>FPGA</e1> для <e2>ускорения расчета волнового фронта цунами</e2> Рассматривается вопрос ускорения численного расчёта распространения волны цунами от очага до берега в рамках дифференциальной модели мелкой воды с применением аппаратного ускорения на базе FPGA.	USAGE
Каждый компонент проекта относится к одному из структурных <e2>уровней анализа текста</e2> : структурный, семантический, прагматический <e1>.</e1>	PART_OF
Каждый компонент проекта относится к одному из структурных <e2>уровней анализа текста</e2> : структурный <e1>,</e1> семантический, прагматический.	PART_OF
Разработка прецедентно - ориентированного подхода обратного реинжиниринга web - интерфейсов Статья посвящена применению <e1>рассуждений на основе прецедентов</e1> ( case - based reasoning, CBR ) в области <e2>web - разработки</e2>.	USAGE
Автоматическое извлечение решеток понятий из медицинских текстов на основе комбинации анализа формальных понятий и технологий бутстраппинга Рассматривается новый <e2>способ извлечения понятий</e2> из текстов предметной области на основе комбинации анализа формальных понятий и <e1>бутстрап - технологии информационного поиска</e1>.	USAGE
<e2>Алгоритм оптимизации меню</e2> работает с <e1>языком описания графов DOT</e1>.	USAGE
Широко используемый способ разбиения области на прямоугольные ячейки обладает недостатком : при <e1>сложном строении свободной поверхности</e1> ( например, гора ) возникают <e2>эффекты</e2> при отражении волны от этой поверхности, связанные с тем, что граница аппроксимируется ступенчатой функцией для численного решения задачи.	CAUSE
В статье рассмотрена обобщенная <e2>модель структурной организации единого информационного пространства</e2> по <e1>параллельному методу интеграции средств поддержки жизненного цикла изделия</e1>.	USAGE
Автоматизация построения трехмерных геоэлектрических моделей для метода зонди - рования становлением поля в ближней зоне на основе результатов одномерной инверсии Предложен <e2>алгоритм автоматизации построения трехмерных геоэлектрических моделей</e2> для метода зондирования становлением поля в ближней зоне на основе результатов <e1>одномерной инверсии</e1> с целью расчета синтетических сигналов для трехмерных моделей, а также ускорения получения качественной оценки полевых материалов и сведения к минимуму ошибок интерпретации.	USAGE
Восстановление трехмерной геометрии сосудов по данным компьютерной томографии Рассматриваются <e2>алгоритмы построения триангуляции внутренней поверхности коронарных артерий сердца</e2> по данным <e1>компьютерной томографии</e1>.	USAGE
<e2>Алгоритм предобработки сигнала импульсного нейтронного гамма - каротажа</e2> с учетом <e1>статистической зависимости</e1> соседних элементов спектра На фоне множества методов проведения геофизических исследований выделяется и является одним из перспективных, за счет возможности определения состава горных пород, импульсный нейтронный гамма - каротаж.	USAGE
Целью исследования является разработка <e1>программной системы</e1> для <e2>локализации источников мозговой активности</e2> на основе совместного анализа данных ЭЭГ и сМРТ.	USAGE
Оптимизация переупорядочивания модельных частиц при реализации <e1>метода частиц в ячейках</e1> на <e2>GPU</e2> Представлено описание реализации метода частиц в ячейках на GPU.	USAGE
<e2>Миграция</e2> включает в себя <e1>реинжиниринг приложения</e1> с сохранением бизнес - логики, модели данных, а также перенос самих данных.	PART_OF
Для восстановления трехмерной геометрии применяется комбинация двух основных <e2>методов</e2> : <e1>трехмерного алгоритма роста области из семени</e1> и ячеечного метода, использующего разбиение пространства на тетраэдры.	ISA
Под расширенной моделью понимается тематическая модель, содержащая кроме однословных терминов термины, состоящие из нескольких слов ( также называемые многословные термины или ключевые фра зы ). Такие модели лучше интерпретируются пользователями и точнее описывают предметную область документа, чем модели, состоящие только из униграмм ( отдельных слов ). На основе предложенного <e1>подхода</e1> была разработана <e2>система</e2>, в результате работы которой для каждого документа предоставляется набор содержащихся в нем тем с указанными вероятностями, ключевыми словами и фразами для каждой темы.	USAGE
Разработанный инструментарий <e1>позволяет</e1> проводить унификацию ЭЭГ <e2>- записей</e2>, сделанных на различном оборудовании, восстановление утраченных данных, 3Dреконструкцию источников мозговой активности по исходным ЭЭГ - данным и медиационный анализ.	TOOL
В процессе работы описанного алгоритма могут быть использованы произвольные методы сжатия данных, причем прогнозные значения от разных методов комбинируются, и наибольшее влияние на конечный результат оказывает <e1>метод</e1>, способный сильнее других сжать <e2>временной ряд</e2>.	TOOL
Мобильное приложение непрерывной передачи видеоданных в облачные сервисы Представлен способ получения видеодоказательств с помощью мобильного устройства – приложения <e1>для</e1> Android <e2>,</e2> позволяющего оперативно начать видеотрансляцию в облачные сервисы.	PART_OF
Знания, извлеченные из текстов, формализуются при помощи <e2>атомарных предложений сигнатуры</e2>, состоящей из <e1>символов констант</e1>, двухместных предикатов и дополнительных констант - ситуаций.	PART_OF
Необходимым условием для использования математической статистики, <e2>анализа сигналов</e2> и машинного обучения является наличие должным образом собранных, размеченных и <e1>подготовленных данных</e1>.	USAGE
Описана <e2>предметная область</e2>, связанная с распространением клещей и переносимыми ими заболеваниями, представлена ее <e1>семантическая структура</e1>, выделены основные разделы информационного наполнения и показаны способы навигации по ресурсу.	PART_OF
Для решения этой задачи авторами была проведена серия опытов для получения статистической выборки <e1>образцов клавиатурного почерка</e1>, которые используются в качестве <e2>биометрической характеристики</e2> для установления личности ее владельца.	ISA
Также были реализованы две параллельные версии алгоритма, проведены расчеты на различных многоядерных системах ( на <e1>классической многопроцессорной архитектуре</e1>, а также <e2>архитектуре</e2> с использованием сопроцессоров Intel Xeon Phi – " РСК ПетаСтрим "). Представлены сравнительные тесты ускорений на разных архитектурах, а также описаны особенности распараллеливания алгоритма.	COMPARE
Для анализа данных и <e2>определения автора</e2> конкретного образца почерка в работе рассматривается <e1>метод k - средних</e1>, являющийся одним из наиболее простых и эффективных статистических методов классификации в случае, когда число кластеров заранее известно.	USAGE
Одним из возможных решений этой проблемы является использование эйлерово - лагранжева подхода, в котором физические величины сосредоточены в материальных точках, что характерно для <e1>метода SPH</e1> ( <e2>Smoothed Particle Hydrodynamics</e2> ), а расчет сил производится на адаптивной сетке, привязанной к системе материальных точек.	SYNONYMS
К типичным сферам применения подобных комплексов можно отнести : исследование археологических объектов – курганы, древние поселения ; решение экологических задач – изучение отвалов и хвостохранилищ горнодобывающих предприятий, зон распространения вредных веществ ; локализация <e2>инженерных объектов</e2> – <e1>труб</e1> и коммуникаций, исследование состояния дамб и плотин.	ISA
Каждый компонент проекта относится к одному из структурных <e2>уровней анализа текста</e2> : структурный, семантический <e1>,</e1> прагматический.	PART_OF
<e2>Процесс реферирования</e2> состоит из пяти основных шагов : предобработка, риторический анализ и преобразование текста, <e1>оценка весов</e1>, выбор предложений и сглаживание.	PART_OF
Рассматриваются особенности <e2>конечно элементной аппроксимации прямой задачи</e2>, использующей <e1>базисные функции большого порядка</e1>.	USAGE
В статье также описано применение данной <e1>методики</e1> для организации <e2>тестирования системы NSUts</e2> и проведен анализ ее эффективности.	USAGE
Мобильное приложение непрерывной передачи видеоданных в облачные сервисы Представлен способ получения видеодоказательств <e2>с</e2> помощью мобильного <e1>устройства</e1> – приложения для Android, позволяющего оперативно начать видеотрансляцию в облачные сервисы.	USAGE
Сytoscape – плагин для построения структурных моделей биологических сетей в виде случайных графов Современные методы экспериментальных исследований позволяют реконструировать различного типа <e2>биологические сети</e2>, включая генные и метаболические сети, <e1>сети интерактомики</e1>, сети коэкспрессии генов, сети заболеваний и т.	ISA
<e2>Информационно - аналитическая система</e2> с <e1>алгоритмами геномного анализа патогенов вирусных инфекций</e1> Работа посвящена описанию структуры информационно - аналитической системы « Ixodes », ориентированной на работу c представительной коллекцией иксодовых клещей из разных биотопов, а именно для территорий Алтая, Сибири и Дальнего востока.	PART_OF
<e1>Компьютерная база данных</e1> для <e2>анализа дифференциально экспрессирующихся генов</e2>, связанных с агрессивным поведением, на моделях лабораторных животных Разработка и применение компьютерных средств анализа транскриптомных данных в модельных организмах животных представляет актуальную задачу биоинформатики.	USAGE
Для вычисления <e2>профиля глубин</e2> применялся <e1>метод конечных элементов</e1>.	TOOL
В результате представлена <e1>архитектура вычислительной системы</e1> для сбора, <e2>хранения</e2> и обработки экспериментальных данных.	USAGE
В процессе работы описанного <e2>алгоритма</e2> могут быть использованы произвольные <e1>методы сжатия данных</e1>, причем прогнозные значения от разных методов комбинируются, и наибольшее влияние на конечный результат оказывает метод, способный сильнее других сжать временной ряд.	USAGE
Расчет гравитационного взаимодействия осуществляется путем решения <e1>уравнения Пуассона</e1> для <e2>гравитационного потенциала</e2>.	USAGE
На основе предложенного метода создана <e1>система</e1>, позволяющая получать краткие <e2>аннотации научно - технических текстов</e2> и определять их темы.	USAGE
Предложен алгоритм численного моделирования на основе <e2>численного решения линейной 2D - системы теории упругости</e2>, записанной в смещениях, с использованием криволинейной сетки и <e1>пошагового метода Лагерра</e1>.	USAGE
В работе описывается процесс реализации системы распознавания типа устройства с использованием методов машинного обучения, с последующим выводом на экран его основных заранее отобранных характеристик и отображением пользователю набора вероятных <e1>инструкций</e1> для данного <e2>типа устройств</e2>.	USAGE
Реализация данного <e1>подхода</e1> может быть расширена для других <e2>систем представления стимулов</e2>.	USAGE
Необходимым условием для использования математической статистики, анализа сигналов и <e2>машинного обучения</e2> является наличие должным образом собранных, размеченных и <e1>подготовленных данных</e1>.	USAGE
Основными частями <e2>комплекса</e2> являются : рабочая станция оператора SCADA, рабочая станция оператора модели, среда передачи данных, блок формирования физических сигналов, <e1>блок дублирования физических сигналов</e1> и программируемые логические контроллеры АСУ ТП.	PART_OF
Извлеченная из текстов информация путем преобразования через фрагменты атомарных диаграмм алгебраических систем представляется в виде утверждений в логике описаний ( DL ). Подобное представление позволяет получать тексты с большей выразительностью по сравнению с алгоритмами, где <e2>источником информации</e2> являются <e1>данные</e1>, представленные в виде баз данных или в виде выражений на формализованных языках ( например, SQL ).	ISA
Разработаны комплексы <e1>алгоритмов</e1> и компьютерных программ для <e2>анализа сигналов электромагнитного зонда</e2> с тороидальными катушками в пространственно неоднородных анизотропных средах.	USAGE
<e1>Электроэнцефалография</e1> ( <e2>ЭЭГ</e2> ) – один из наиболее популярных методов исследования мозговой активности.	SYNONYMS
Для восстановления трехмерной геометрии применяется комбинация двух основных методов : трехмерного алгоритма роста области из семени и <e2>ячеечного метода</e2>, использующего <e1>разбиение пространства</e1> на тетраэдры.	USAGE
Программы статистической обработки, кластеризации и визуализации распределения сайтов связывания транскрипционных факторов в геноме Исследование регуляции транскрипции генов на основе данных современных технологий высокопроизводительного секвенирования является актуальной задачей биоинформатики, требующей развития новых <e2>компьютерных средств</e2>, в том числе на основе <e1>суперкомпьютерных вычислений</e1>.	PART_OF
В этой работе мы описываем технологию переноса программного обеспечения, примененную к компилятору Clang ( и другим необходимым инструментам ) и предлагаем метод ускорения компиляции, автодополнения и <e1>анализа кода</e1> в нашей <e2>IDE</e2>.	PART_OF
Описана реализация приложения <e2>и</e2> показан разработанный интерфейс <e1>.</e1>	PART_OF
Несмотря на большое разнообразие подходов к решению данной <e2>задачи</e2>, в частности с использованием <e1>метода матрицы структуры проекта</e1>, предлагаемые решения не обеспечивают непосредственную связь между элементами описываемой структуры и используемыми аппаратными и программными средствами.	USAGE
В работе предлагается <e1>подход</e1> к <e2>формализации структуры ЕИП предприятия - разработчика МЭС</e2> призван устранить данные недостатки.	TOOL
Разработанное новое <e2>программное приложение</e2> основано на <e1>web - технологиях</e1> и имеет клиент - серверную архитектуру.	USAGE
<e2>Разработка информационной системы</e2> по клещевой опасности на основе <e1>онтологии</e1> предметной области Предложен подход к разработке состава и структуры Интернет - ресурса на основе онтологии предметной области.	USAGE
<e1>Электроэнцефалография</e1> ( ЭЭГ ) – один из наиболее популярных <e2>методов исследования мозговой активности</e2>.	ISA
Результаты работы <e1>алгоритма</e1> представляют собой подготовленные <e2>трехмерные модели изучаемой среды</e2> с рассчитанным синтетическим электромагнитным сигналом.	CAUSE
